As the sun sets on the plains, the sheriff angrily snaps on the cuffs. You are shoved into the coach and land on top of Muddy Charlie and the pile of silver dollars, which until recently had been the property of the Missouri, Kansas & Texas Line.

Muddy furtively whispers, "Hang tight, Rick! You done good blowing up that tunnel -- I just didn't plan on the sheriff getting word ahead of time, is all. That were powerful bad luck."

The sheriff climbs onto his horse, spits, and you begin to rumble forward. "You boys really got it coming this time," he yells back cheerfully.

Muddy shakes his head. "No offense, Sheriff, but I reckon you got the wrong men. We was just on our way to the theater."

The sheriff disagrees. "The only place you boys are heading is straight to the... 

Hoosegow
A Wild West Wreck by Ben Collins-Sussman and Jack Welch
Release 1 / Serial number 100118 / Inform 7 build 5Z71 (I6/v6.31 lib 6/12N) SD
Type "help" for instructions, credits, and license -- or just roll into town guns a-blazin'.

[Press Space To Continue]

In the twilight, you sight the sheriff's sturdy brick office near the edge of town. "That's mighty fine construction," notes Muddy, sounding less feisty now. "Mighty fine indeed." The coach rolls to a halt and a thick arm yanks you roughly from your seat. You land awkwardly in the rutted street, where the sheriff holds you in place with the heel of one boot. He yells to his men, "Bring the coach on around, we got to impound that evidence." You are manhandled into the sheriff's office and shoved into a small holding cell.

The deputy wakes with a start, whips his dusty boots off the desk and stands, tucking his shirt back into his pants. The sheriff gives him a brief, judgmental glance and offhandedly tosses an arrest warrant on the desk. He barks, "Jimbo, listen up. Picked up these two down near the train. A federal marshal will be coming for them at eight o'clock tomorrow morning. There's going to be a hanging!". The deputy nods slowly. The sheriff continues, "Please take care of our 'guests'. I got to head down to Wichita Falls to discuss my invention with some investors, so you is in charge." The deputy smiles until the sheriff adds, "Jimbo, don't screw up," as he heads out the door.

Jail Cell
Why are you not surprised to have landed right back in the hoosegow after another one of Muddy's dubious plans? Will you ever learn? You weren't brought up for this sort of life -- how did it come to this? 

The small jail cell is brick on three sides, metal bars on the other, with a tightly locked gate.  A small window is set into the brickwork above your head.  Through the jail bars you can see the sheriff's office.

A broken stool lies on the floor.

Muddy leans against the wall tapping a harmonica on his arm.

In the corner of the cell, a disheveled man in a black suit is stretched out on a crude wooden bench and is snoring loudly, oblivious to your presence.

>x boots
Black boots that have seen better days. The left boot is missing its heel spur.

Back in the office, the deputy sniffles loudly and wipes his nose on his sleeve.

* * *

>take harmonica
"I ain't never seen you play the mouth organ, Muddy."

Your partner turns the harmonica back and forth, and a chain rattles. "That's 'cuz I ain't never learned how", he replies.

Muddy hands the harmonica to you.

>play harmonica
You tentatively blow on it a bit, but you're not rightly sure what you're doing.

The deputy grimaces, "Knock off that racket, you two. A noise like that, a man can't get to thinking straight. Settle down now, you hear? I got me some reading to do." The deputy unfolds the warrant, furrows his brow and begins reading. You can tell because his lips are moving. Slowly.

Over in the office, the deputy reaches into his pocket, produces a strip of beef jerk and chews on it for a while.

>play harmonica
The deputy cringes, as you blow not only the notes that are built into the harmonica, but every note in between as well. He stands up, shoves the warrant into his pocket, and grabs a bottle of whiskey off the cabinet.

"I declare: that's just the worst thing I ever heard in my life. It's enough to drive a man to drink." To prove it, he takes a mighty swig from the whiskey bottle and wipes his mouth with the back of his sleeve. The deputy puts his fingers in his ears and tries to ignore you.

You keep playing.

The deputy balls his hands into fists and trembles with annoyance, "I'm going to the saloon to listen to some real music, from some real talented lady folk of the female persuasion." The deputy walks out the front door in a huff.

"You should hear me play piano," you remark, but he's already out of earshot.

Muddy says, "Nice one.  Hey -- I reckon I saw that screw up there wiggle a bit when you played the harmonica. I didn't say nothing on account what the deputy was here."  He points to a screw holding in one of the cell bars.

A fly buzzes past your ear and lands on the ceiling.

>z
Time passes.

The deputy pokes his head back in the office and remarks, "I've about had enough of you characters. You can stew in your own juices here. I got important things to do over yonder in the saloon. But I reckon I would be dairy licked to leave you jokers alone."

The deputy grabs a dinner bell from the hook where it hangs next to the office door, and he rings the bell slowly a few times. Nothing happens. He rings it again. Minutes go by, and the deputy waits impatiently. Finally, a fat bloodhound waddles leisurely through the door way, tempted by the dinner bell.

The deputy reaches into his pocket and retrieves a scrap of beef jerky. He pitches it into the dog's bowl and the bloodhound gobbles it down. The deputy leads his mangy old dog towards the office's strange looking steam boiler and ties him to it with a leash.

"This here's Flash, my hunting dog. I got to warn you that he can be vicious when he gets riled up, so don't cross him." Flash slowly slumps down next to the boiler, enjoying the heat. His heavy eyes close and drool drips from his toothless mouth.

"Flash here's apt to rip your throat out if you so much as look at him funny, but I got him hooked up here to the sheriff's fancy steam contraption." The deputy narrows his eyes distrustfully. "If you boys were so stupid as to make for the jailhouse door, 'ol Flash would yank that lever and set off the steam whistle on the roof. The sheriff installed it special for me, so as I can come when he wants me. I can hear that half way across town, and if'n I do hear it, then you'll have to deal with me *and* Flash." The deputy gives Flash one last pat on the head, swigs the whiskey one more time, and departs for the saloon.

* * *

>xyzzy
You ponder your life.

For a brief moment, you wonder if your situation is but a painting in the mind of an artist;  a meditation on form, an impression of rural life on the verge of industrialization as abstracted in the modern style.

On the other hand, it may just be indigestion.

Back in the office, the deputy runs his hand through his sparse hair.

>xyzzy
Absolutely nothing happens.

On the other side of the jail bars in the office, the deputy peeks through the jail cell window at the saloon across the street. It's clear he'd rather be there.

>xyzzy
bar
Back in the office, the deputy peeks through the jail cell window at the saloon across the street. It's clear he'd rather be there.

>xyzzy
bar
Over in the office, the deputy watches you with a bored expression.

* * *

>x bench
A long wood bench made of rough, splintery planks. Under the bench, you notice the remnants of a meal.

Over in the office, the deputy watches you with a bored expression.

>x meal
On closer inspection, it looks like a rancid piece of meat, a metallic can and a spoon.

The deputy has been watching you out of the corner of his eye and he smiles sardonically. "I see you found your dinner. Or was that last week's dinner? Har, har!"

On the other side of the jail bars in the office, the deputy reaches into his pocket, produces a strip of beef jerk and chews on it for a while.

>take can
Fetched.

In the office, the deputy stares at Muddy.

>take spoon
Fetched.

Back in the office, the deputy runs his hand through his sparse hair.

>x can
A closed metal can with a paper label saying "BEANS". On the back, some fine print says, "Precooked beans. No claim is made regarding the cardioprotective nature of this product. May cause abdominal distension if ingested. No fitness of purpose is implied. No warranty is provided for personal or other injury, or injury or loss related directly or indirectly to the use of this product. By opening this can, you agree to the terms of service posted in town."

On the other side of the jail bars in the office, the deputy pokes his head out of the office and yells at some passersby.

>x boots
Black boots that have seen better days. The left boot is missing its heel spur.

In the office, the deputy looks tired.

>x right boot
A cowhide boot that has been rubbed smooth. A metal riding spur is about ready to fall off the worn down heel.

Over in the office, the deputy peeks through the jail cell window at the saloon across the street. It's clear he'd rather be there.

>take spur
You yank the spur off your right boot, being careful not to cut yourself in the process.

In the office, the deputy sniffles loudly and wipes his nose on his sleeve.

>open can with spur
You open the can of beans with the spur.
[Your score has just gone up by one]

Back in the office, the deputy repeatedly counts his fingers, but is unable to get a firm answer.

>eat beans
When you were a child, you remember visiting your cousins, who all liked beans. Your aunt insisted that if they could eat beans, so could you. You choked on them, and coughed them up, and they made fun of you. Since then, you don't even like the way they smell. The beans, that is. Actually, your cousins are kind of rank too.

Nonetheless, your stomach is growling and you could do with a meal.

[You have dealt with a repressed childhood memory in a constructive manner, your score just went up by two points]

On the other side of the jail bars in the office, the deputy inspects his LeMat revolver lovingly.

>eat beans
The beans disgust you even more than the rancid meat.

[The thought is enough to make you lose a point.]

Over in the office, the deputy warms his hands near the boiler.

>eat beans
No. It's a matter of principle now.

[Your score just went back up by a point for being so principled.]

Back in the office, the deputy makes you nervous as he waves his gun back and forth, jerking the barrel up and shaping the words "Pow! Pow!" with his lips.

>eat beans
Give Muddy the damn beans. He likes them, but they you can't stand to even look at them.

Muddy tugs down on his vest, which had ridden up a bit.

>give beans to muddy
Muddy takes the can and stares hungrily at the beans.

Even in the most dire situation, Muddy's appetite remains intact. He looks expectantly at you and says, "Rick, got a spoon?"

On the other side of the jail bars in the office, the deputy looks tired.

>give spoon to muddy
Muddy cracks a gap-toothed smile and says, "Much obliged," before digging into the can of beans like a miner hot on a fresh gold vein. A couple moments later, he finishes circling the inside of the can with the spoon, trying to get every last drop of bean juice into his mouth. Afterwards, he places the can and spoon on the floor and rubs his stomach with satisfaction.

Muddy has an aura of well-fed contentment.

* * *

>z
Time passes.

Muddy wraps his arms around his belly, and moans softly, "I might have overdone it with them beans."

The deputy looks up from his reading, curious. 

"Ain't you gonna ask me about my plan?" Muddy whispers.

>z
Time passes.

Muddy doubles over, "Rick, you should get to high ground. I'm feeling a mite bloated after them beans, and I think you know what's coming!"

"Where the Sam Hill do you think I'm going to run to, Muddy? We're locked up in a hoosegow! Deputy, if'n I was you, I would put some distance between Muddy and your nose.
"

The Deputy looks concerned, but confused. 

"This time mah plan is sure fire -- go ahead, ask me. C'mon." Muddy jibes quietly.

>z
Time passes.

You hear nothing. The smell nearly knocks you out. Vision fades, the room spins.

Muddy whispers in that understated manner of his, "That were a silent but deadly."

"Ain't you even a speck curious to ask me about my plan?" taunts under his breath Muddy.

>z
Time passes.

Suppressing the urge to throw up from the smell, the deputy reaches over to the whiskey bottle and half drains it on his way out the door.

The fragrance gradually improves as the universe cools.
[Your score has just gone up by one]

"Truthful, Rick," whispers Muddy solemnly, "this ain't like all my other plans, this one is iron-clad. Ask me about it. Go ahead."

>z
Time passes.

Muddy vibrates with excitement and gushes, "I got to tell you, Rick, or this new plan of mine is going to drive me plumb crazy!" 

"Let's keep this between us, though", he whispers.

He notices the sleeping man in your cell for the first time. "Don't know about him." Muddy jerks his thumb towards the sleeping figure. "Might be a spy."

Muddy leans towards you, his face barely an inch from your ear and his buzzard-worthy breath even less so from your nose. "Okay, Rick, I'm a-going to tell my plan." Muddy pauses dramatically. "Here it is: we got to break out of this jail before we get strunged up."

"That's it? That's your whole damn plan? That don't count as no plan!" you fume.

"Keep it down, Rick!" Muddy's gaze darts between the deputy and your third cellmate. "Yeah, that's it for now. It takes time to cook up a good plan. You need lots of ingredients."

"Muddy," you retort, "I heared you was the worst cook in the Confederate Army. Your cooking like as did more damage than Sherman's March."

Muddy gives you a hurt look and sulks in the corner. After a while, you regret being so quick-tempered with your old buddy.

>z
Time passes.

The deputy pokes his head back in the office and remarks, "I've about had enough of you characters. You can stew in your own juices here. I got important things to do over yonder in the saloon. But I reckon I would be dairy licked to leave you jokers alone."

The deputy grabs a dinner bell from the hook where it hangs next to the office door, and he rings the bell slowly a few times. Nothing happens. He rings it again. Minutes go by, and the deputy waits impatiently. Finally, a fat bloodhound waddles leisurely through the door way, tempted by the dinner bell.

The deputy reaches into his pocket and retrieves a scrap of beef jerky. He pitches it into the dog's bowl and the bloodhound gobbles it down. The deputy leads his mangy old dog towards the office's strange looking steam boiler and ties him to it with a leash.

"This here's Flash, my hunting dog. I got to warn you that he can be vicious when he gets riled up, so don't cross him." Flash slowly slumps down next to the boiler, enjoying the heat. His heavy eyes close and drool drips from his toothless mouth.

"Flash here's apt to rip your throat out if you so much as look at him funny, but I got him hooked up here to the sheriff's fancy steam contraption." The deputy narrows his eyes distrustfully. "If you boys were so stupid as to make for the jailhouse door, 'ol Flash would yank that lever and set off the steam whistle on the roof. The sheriff installed it special for me, so as I can come when he wants me. I can hear that half way across town, and if'n I do hear it, then you'll have to deal with me *and* Flash." The deputy gives Flash one last pat on the head, swigs the whiskey one more time, and departs for the saloon.

>x man
The man crumpled in the corner appears to be wearing a black suit and a pastor's neck tie. He'd almost look respectable, if it weren't for the immediate environment. He reeks of booze and snores loudly. A pamphlet is sticking out of his pocket. You don't consider yourself a common pickpocket, but it makes you wonder what else he might have on him.

"Ain't you even a speck curious to ask me about my plan?" taunts under his breath Muddy. 

"That worked out well," says Muddy proudly.

"For you maybe," you reply. "But I near as lost my lunch what with that stench."

To which Muddy counters, "Ain't much worse than your feet, I reckon."

* * *

>ask muddy about plan
I already done told you -- we got to bust out.

"That worked out well," says Muddy proudly.

"For you maybe," you reply. "But I near as lost my lunch what with that stench."

To which Muddy counters, "Ain't much worse than your feet, I reckon."

>take harmonica
"I ain't never seen you play the mouth organ, Muddy."

Your partner turns the harmonica back and forth, and a chain rattles. "That's 'cuz I ain't never learned how", he replies.

Muddy hands the harmonica to you.

>play harmonica
Tentatively, you blow a few notes. The bars in the jail cell rattle sympathetically.

"Look at that, boy", Muddy laughs, "I swear that screw up there holding that bar is wiggling loose!"

>play harmonica
Again, the room resonates with the rich and vibrant tones of a bagpipe connected to the blowhole of a baluga whale.

Muddy points excitedly towards the top of the gray bar, "When you played, that screw worked its way out more. It's like you got some kind of sonic screwdriver or something! I think one more time will do it."

Flash rolls almost imperceptibly to the right.

>play harmonica
The screw vibrates out of the ceiling, rebounds in a shower of sparks off the concrete floor of the jail cell rolls under the deputy's desk.   A gray bar falls loose from the ceiling and lands at your feet.

"You done it!" shouts Muddy."

It feels cooler than it did last night.

>take bar
(the gray bar)
You hold it lengthwise and stare down its hollow shaft at Muddy. He looks back at you.  "Don't that just beat all," ponders Muddy.
[Your score has just gone up by one]

>put bar in socket
(the gray bar in the socket)
You flip the stool over and wiggle the hollow gray tube into the empty socket. It fits perfectly and remains in place when you let go of the bar, but you think you could yank the gray bar out again if you needed it. You now have a stool with three even legs: two wood, one metal.

Muddy hums "Camptown Races", singing the "Doo-Dars" off key. The effect is annoying.

>stand on stool
Muddy holds it steady as you climb up. Your head is now even with the top of the window.

Jail Cell (on the stool)
The small jail cell is brick on three sides, metal bars on the other, with a tightly locked gate.  A small window is set into the brickwork above your head.  Through the jail bars you can see the sheriff's office.

Muddy leans against the wall.

In the corner of the cell, a disheveled man in a black suit is stretched out on a crude wooden bench and is snoring loudly, oblivious to your presence.

You can also see a can of beans (in which is a spoon) and a hunk of meat here.

In the office you can see Flash.

>look out window
The jail is at the end of a long street. Directly across the street is a saloon, which is open, unlike the stores on both sides of the street which have pulled down their shades for the evening. Below the window there is a covered barrel; you can almost touch its top. Just to the left of the window, a berry-covered vine has grown up the side of the building. 

Up in the sky, you notice a couple of hungry, circling vultures.

>x vine
The leafless tip of a wiry vine pokes into the cell through the window. It's covered with small red berries.

* * *

>put berry in bar
(the gray bar)
You drop the berry into the gray bar.

>blow berry at coffee
The berry splatters against the side of the cup, and its juice drips into the steaming brew.

Muddy jumps up, claps you congratulatorily on the back, and you nearly swallow the metal tube still held to your lips.

He beams, "That were a one in a million shot, Rick!"  Muddy strokes his chin and wags a finger at the coffee, "Now, if we can only get the deputy to come back and drink that coffee, he might be a whole lot more cooperative, I reckon."

You sure like the way Muddy thinks.

Flash has died. Wait. Sorry. He's just really immobile.

>take off left shoe
You ain't able to see no such thing.

>take off left boot
Oh, you really don't want to do that. Not indoors at least. Are you sure?

(yes or no) >

* * *

>take off right boot
In some states that's a felony. Are you sure?

(yes or no) >

>yes
You rock back and forth on the floor, locked in a death struggle with your foot. Beads of sweat form on your head, as you struggle to twist and pull the boot off. With a sudden sucking pop, the boot relents and you tumble backwards.

Muddy's eyes water as he complains, "Not again! My poor nose!"

One foot was bad enough, but two is more than the old dog can handle. Trying not to sniff the air, flash turns tail and breaks for the door, straining against his leash which is tied to the steam pipe lever. The lever swings towards the door, and from the roof you hear the ear-splitting drone of a railway steam whistle.

You agree with with Muddy that the deputy is not likely to be in a good mood when he arrives, so you put your boots back on.

>z
Time passes.

The Deputy slams through the swinging doors to the office, lurching to the side as he struggles to put his other leg into his pants. He is bare-chested and empty handed, aside from a nearly empty bottle of whiskey. Flash is so scared that he snaps his leash.

The deputy thunders, "What the hoot-hollering blazes is the matter here?" The deputy surveys the office quickly and then rattles the gate to make sure it is still locked. In his drunk rage, he doesn't notice the missing metal bar.

Satisfied that you haven't escaped, he pushes the lever back to the middle position. "Dumb dog. I was doing important business." He looks around for Flash, but the dog has already slid out of the office. 

The deputy brightens. "Ummm. I do smell me some coffee." The deputy drains the mug with a single gulp. "That's good. I got to wake me up some."

Almost immediately, the deputy spins on his heel and drops to the floor just in front of your jail cell.

>x deputy
You are relieved to find that the deputy is unconscious, but breathing. He is wearing only a pair of pants -- no shirt, no gunbelt, no boots.

* * *

>put berry in bar
(the gray bar)
You drop the berry into the gray bar.

>take off left boot
In some states that's a felony. Are you sure?

(yes or no) >

>yes
You rock back and forth on the floor, locked in a death struggle with your foot. Beads of sweat form on your head, as you struggle to twist and pull the boot off. With a sudden sucking pop, the boot relents and you tumble backwards.

Muddy's eyes water as he complains, "Ain't you got no sense of smell in that head of yours?"

To which you reply, "Not after I been downwind of you around feeding time, nope. This ain't nothing next to what you can do with a can of beans!"

Flash wakes with a start and sneezes loudly. The fur on his back bristles and he opens his eyes to stare in horror at your feet. He backs away, towards the front door. The leash pulls taut. He seems caught in the balance between an urge to run away from your stinky foot and his own laziness which holds him to the spot.

* * *

>z
Time passes.

The Deputy slams through the swinging doors to the office, lurching to the side as he struggles to put his other leg into his pants. He is bare-chested and empty handed, aside from a nearly empty bottle of whiskey.

The deputy thunders, "What the hoot-hollering blazes is the matter here?" The deputy surveys the office quickly and then rattles the gate to make sure it is still locked. In his drunk rage, he doesn't notice the missing metal bar.

Satisfied that you haven't escaped, he pushes the lever back to the middle position. "Dumb dog. I was doing important business." 

The deputy brightens. "Ummm. I do smell me some coffee." The deputy drains the mug with a single gulp. "That's good. I got to wake me up some."

The deputy looks at the two of you.  "Enough is enough.  You jokers stay put, I'll be back again in a bit."

The deputy watches Flash slink back into the office before sauntering out again.

>l
Jail Cell (on the stool)
The small jail cell is brick on three sides, metal bars on the other, with a tightly locked gate.  A small window is set into the brickwork above your head.  Through the jail bars you can see the sheriff's office.

Muddy leans against the wall.

In the corner of the cell, a disheveled man in a black suit is stretched out on a crude wooden bench and is snoring loudly, oblivious to your presence.

You can also see a can of beans (in which is a spoon) and a hunk of meat here.

On the machine is a cup (in which are a cup of coffee).

In the office you can also see Flash.

>blow berry at coffee
The berry splatters against the side of the cup, and its juice drips into the steaming brew.

Muddy jumps up, claps you congratulatorily on the back, and you nearly swallow the metal tube still held to your lips.

He beams, "That were a one in a million shot, Rick!"  Muddy strokes his chin and wags a finger at the coffee, "Now, if we can only get the deputy to come back and drink that coffee, he might be a whole lot more cooperative, I reckon."

You sure like the way Muddy thinks.
[Your score has just gone up by one]

* * *

>z
Time passes.

The Deputy slams through the swinging doors to the office, lurching to the side as he struggles to put his other leg into his pants. He is bare-chested and empty handed, aside from a nearly empty bottle of whiskey. Flash is so scared that yanks the leash and snaps the lever clear off the machine.

The deputy thunders, "What the hoot-hollering blazes is the matter here?" The deputy surveys the office quickly and then rattles the gate to make sure it is still locked. In his drunk rage, he doesn't notice the missing metal bar.

"Dumb dog. I was doing important business."  He looks around for Flash, but the dog has already slid out of the office. 

The deputy brightens. "Ummm. I do smell me some coffee." The deputy drains the mug with a single gulp. "That's good. I got to wake me up some."

Almost immediately, the deputy spins on his heel and drops to the floor just in front of your jail cell.
[Your score has just gone up by one]

>get off
Which way? West to the jail cell, or east towards the open range?

>l
Jail Cell (on the stool)
The small jail cell is brick on three sides, metal bars on the other, with a tightly locked gate.  A small window is set into the brickwork above your head.  Through the jail bars you can see the sheriff's office.

Muddy leans against the wall.

In the corner of the cell, a disheveled man in a black suit is stretched out on a crude wooden bench and is snoring loudly, oblivious to your presence.

You can also see a can of beans (in which is a spoon) and a hunk of meat here.

In the office you can see a deputy.

>get off stool
You jump down to the ground again.

Jail Cell
The small jail cell is brick on three sides, metal bars on the other, with a tightly locked gate.  A small window is set into the brickwork above your head.  Through the jail bars you can see the sheriff's office.

A repaired stool stands upright.

Muddy leans against the wall.

In the corner of the cell, a disheveled man in a black suit is stretched out on a crude wooden bench and is snoring loudly, oblivious to your presence.

You can also see a can of beans (in which is a spoon) and a hunk of meat here.

In the office you can see a deputy.

>get meat
Yuck. You are holding the rancid meat.

Fetched.

>get on stool
Muddy holds it steady as you climb up. Your head is now even with the top of the window.

Jail Cell (on the stool)
The small jail cell is brick on three sides, metal bars on the other, with a tightly locked gate.  A small window is set into the brickwork above your head.  Through the jail bars you can see the sheriff's office.

Muddy leans against the wall.

In the corner of the cell, a disheveled man in a black suit is stretched out on a crude wooden bench and is snoring loudly, oblivious to your presence.

You can also see a can of beans (in which is a spoon) here.

In the office you can see a deputy.

>put meat on barrel
The hunk of meat drops on top of the covered barrel that is just beneath the window. Almost immediately, a vulture drops from the sky, lands on the barrel, and begins tearing into the rancid meat.

* * *

>search deputy
You rifle through his pants pockets and find a federal warrant. You also find a small brass key. Naturally, you take both.

>get off stool
You jump down to the ground again.

Jail Cell
The small jail cell is brick on three sides, metal bars on the other, with a tightly locked gate.  A small window is set into the brickwork above your head.  Through the jail bars you can see the sheriff's office.

A repaired stool stands upright.

Muddy leans against the wall.

In the corner of the cell, a disheveled man in a black suit is stretched out on a crude wooden bench and is snoring loudly, oblivious to your presence.

You can also see a can of beans (in which is a spoon) here.

In the office you can see a deputy.

>open gate with key
(the gate with the small brass key)
The key is way too small to fit the medieval lock which imprisons you.

* * *

>x warrant
A piece of paper with black printing and red handwriting.

>read warrant
"Muddy, this here's a federal warrant!"

"What's it say, Rick?"

I'm a-reading it now: FEDERAL WARRANT. This warrant is issued this eleventh day of December in the year of Our Lord Eighteen Hundred and Sixty Nine and duly executed by the hand of United States Army Major General Philip H. Sheridan of Fort Sill, the Indian Territory of these United States of America. The fugitives Mudlark Abercromby MacGyver alias "Muddy," alias "Mudshoe," alias "Pensicola Thelma," and one Major Richard Carter, alias "Gentleman Rick," alias "Poor Richard," alias "Gumball Ricky," both formerly of the Confederate States Army, having been implicated by observation and circumstance of innumerable delicta, dacoiteries, iniquities, infringements, infractions, and indeed immorality, as well as trangressions, trespassing and trainstopping, are considered deleterious and detrimental to the welfare of the State, and THEREFORE, ordered thereupon that a Mittimus be made out to keep them confined until such time as they be discharged for proper hanging -- It's signed by the General."

"Mittimus?"

"I reckon it's after Thanksgiving, before Easter."

Muddy gives you that familiar old look that always leads to trouble. "I got me another cunning plan. C'mon, ask your old buddy Muddy..." Muddy leans forward, clearly impatient for you to ask him about his latest stroke of (in his opinion) genius."

>ask muddy about plan
Muddy says excitedly, "Here's my idea: I reckon I could take that warrant and forge a different ending. Maybe trick them into releasing us."

"That's a great idea, Muddy, let me get my pen and some ink. Oh, wait a minute. I don't have either!" You glare at Muddy.

"Oh, yeah. I suppose. I didn't think of that." Muddy considers the matter. "Maybe we could make one. If you can find something that I can use as a pen, I reckon that one of them red berries would make a right proper kind of ink for it."

* * *

>give warrant to muddy
Muddy accepts the document and stares at it for a while, turning it this way and that.

Muddy applies his quill to the paper and with a few flourishes, scrawls an additional sentence on the warrant. He blows gently on it to dry the "ink" and hands the warrant back to you for your inspection.

>read warrant
It says: FEDERAL WARRANT. This warrant is issued this eleventh day of December in the year of Our Lord Eighteen Hundred and Sixty Nine and duly executed by the hand of United States Army Major General Philip H. Sheridan of Fort Sill, the Indian Territory of these United States of America. The fugitives Mudlark Abercromby MacGyver alias "Muddy," alias "Mudshoe," alias "Pensicola Thelma," and one Major Richard Carter, alias "Gentleman Rick," alias "Poor Richard," alias "Gumball Ricky," both formerly of the Confederate States Army, having been implicated by observation and circumstance of innumerable delicta, dacoiteries, iniquities, infringements, infractions, and indeed immorality, as well as trangressions, trespassing and trainstopping, are considered deleterious and detrimental to the welfare of the State, and THEREFORE, ordered thereupon that a Mittimus be made out to keep them confined until such time as they be discharged for proper hanging of the Sheriff's portrait on the office wall.

>show warrant to deputy
The deputy groans deeply and curls up into a ball. You keep poking him with your finger, and finally he rolls towards you, blinking quickly. His half-focused eyes drift from you to Pastor Pete and finally fix on Muddy who gives him a full-toothed (as many as Muddy still has, at any rate) grin.

The disoriented deputy asks, "What? What in tarnation happened?"

Muddy takes the initiative, "I reckon you must've drunk some potent firewater, deputy. You plumb passed out. Now, why don't you get up and let us out, we got work to do -- just like it says on that federal warrant."

The dull-witted deputy, still stunned by the recent turn of events stares at the warrant.

Muddy leans forward and points out, "Down there, near the bottom. It says that we should be discharged to hang up the sheriff's portrait, don't it?"

The deputy yawns and rubs his eyes, "I reckon it do. But I thought you was criminals."

"Oh shucks, no, deputy." Muddy puts on his most endearing smile. "Don't you remember the sheriff asking you to take care of his guests? We were just staying here overnight. Now, why don't you let us out? The sheriff's going to be mad at us all if that picture ain't hung by morning."

The deputy reaches down and does something arcane to the lock. You don't quite see what he did, but it clicks open. He slumps wearily against the jail bars and the gate swings open, permitting passage eastward into the office.

>e
As you leave to go, the harmonica is yanked away from you by the wall-chain.

[Your score has just gone up by five]

Office
A one room jailhouse is fitting for this jerkwater town. There's a big, wooden desk in the middle of the room, and behind it sits the deputy. Just behind the desk is a fancy cabinet, with real glass in the door. Next to the cabinet, a large, framed picture of the sheriff stands on the floor. To the side of the desk, there is a weird looking contraption: clearly, some sort of steam boiler which is connected by pipes to a strange looking machine. On the opposite side of the room, two swinging doors lead back to town. Flash's empty dog food bowl is nailed to the floor just in front of your jail cell.

Muddy leans against the wall.

You can also see a deputy here.

A repaired stool stands upright.

In the corner of the cell, a disheveled man in a black suit is stretched out on a crude wooden bench and is snoring loudly, oblivious to your presence.

In the jail cell you can also see a harmonica and a can of beans (in which is a spoon).

>tree
compass (6) 
  the north
  the northeast
  the northwest
  the south
  the southeast
  the southwest
  the east
  the west
  the up
  the down
  the inside
  the outside
(darkness object) (7) 
(Inform Parser) (8) 
(Inform Library) (9) 
(property_numberspace_forcer) (10) 
(ValuePropertyHolder) (31) 
Library message debug (44) 
I7_LibraryMessages (45) 
jail cell (46) 
  a harmonica
  a can of beans (open)
    a spoon
  a footwear
  a cell window
  a stool
  a bench
  some bars
  Pete
your former self (47) 
office (64) 
  Muddy
    a feather
    a frock coat (being worn)
    suit (being worn)
  a saloon
  a gate
  a corn
  a deer
  some fields
  a range
  an outdoors
  some vultures
  a sky
  some walls
  a ceiling
  yourself
    a warrant
    a small brass key
    your right boot (being worn)
    your left boot (being worn)
    a gray bar (empty)
    a spur
    your pocketwatch
    your hat (being worn, and open but empty)
    your pants (being worn)
    a scrap of paper
    your overcoat (being worn)
  a deputy
    a cigar
    a bottle of whiskey
  some swinging doors
  a boiler
  a cabinet (closed)
    a banana
    a gun belt
  a chair
  a desk
  a portrait
  a machine
Usually a thing (76) 
Limbo (77) 
  Flash
  a cup
    a cup of coffee
  a screw
  a stain
  some army guards
  a marshal
  a sheriff
gap (85) 
jailhouse (92) 
hook (97) 
  a bell
grate (99) 
ball (100) 
lever (101) 
top of the cabinet (102) 
cabinet door (104) 
holster (105) 
  your gun
drawer (107) 
  a folder (closed)
    a telegram
    a patent
    a note
    a receipt
metal lock (113) 
paper (114) 
antelope (119) 
iron pipe (121) 
nozzle (122) 
chute (123) 
whiskey bottle (124) 
jail door (125) 
floor (126) 
gate lock (128) 
bronze plate (129) 
seat (130) 
initials (131) 
socket (132) 
harmonica-textbox (133) 
chain (134) 
street (137) 
  a barrel
    a hunk of meat
    a vulture
  a vine
rods (141) 
berry (142) 
collar (144) 
colar (145) 
leash (146) 
pocket (147) 
  a pamphlet
  a tin (closed)
    a wad of tobacco
mouth (151) 
your mouth (152) 
mount (155) 
tail (156)

>x desk
A beat-up old wooden desk with time-worn corners, and a pitted, scratched surfacee. The rear of the desk has a small drawer.

>open drawer
It seems to be locked.

>search deputy
You don't find anything else but pocket lint.

>open drawer with key
You unlock the drawer.

>open drawer
You slide the drawer open revealing a folder.
[Your score has just gone up by one]

>open folder
You open the folder, revealing a telegram, a patent, a note, and a receipt.

* * *

>x patent
A thick technical document describing the coffee machine invented by the sheriff. Reading through it, you can see his plans to make these machines in factories and to sell them throughout the country. Your mind reels in horror at the prospect of coffee shops on every street corner selling fancy, steamed beverages.

>x note
The note is written in a flowing cursive script. It reads:

"Dear Sam, I can't go on like this. When you were just a plain old sheriff that was one thing, but since you started inventing stuff, I can see what you are made of. A man that kicks my dog isn't cut out for marrying anyone. I thought you were an honest law man, but I can see what you've become. Don't come around no more or my pa might just take a disliking to you. I was going to send you my ring, but I found out it was glass. Why am I not surprised? You are a scoundrel and not fit to wear that uniform.

Explicitly not yours,

Ella".

>x receipt
A receipt from Jeffries & Brand Steam Works Co Ltd of Witchita Falls. The receipt is for four hundred dollars worth of pipes and fittings purchased by Sheriff Sam Cheney of Crawdad's Gulch. At the bottom of the note, written in red is the following postscriptum: "Your account with us is severely in arrears. No further credit will be extended. Remit all payments immediately or we will take legal or other actions as required.".

>take all
You can't use multiple objects with that verb.

>take telegram, patent, receipt
You can't use multiple objects with that verb.

>take telegram
Fetched.

* * *

>take receipt
Fetched.

>x cabinet
(the cabinet)
About three feet tall, and made of oak. The cabinet's top is covered with circular stains from drinking bottles, but the rest of the cabinet is in good shape. Its door covers the front of the cabinet and opens on brass hinges. The contents of the cabinet are recognizable through the cabinet's uneven glass. Despite the distortion, you see what looks like a gun belt some kind of shiny yellow object. Maybe gold, you think, hopefully.

>open cabinet
(the cabinet)
The cabinet opens to reveal two gun belts and a banana.

"Come to papa!" beams Muddy, as he reaches for his gun belt and straps it on.

* * *

>x gun
You quickly inspect your gun and are alarmed to discover that it's unloaded.

>x muddy
Muddy is well... muddy. His dated tweed three-piece suit is tattered, and doesn't at all match his formal frock coat, which is covered with dust and mud. In short, he hasn't changed a jot since the day you were both picked up for desertion and thrown in the stockade.

>l
Office
There's a big, wooden desk in the middle of the room, and behind it sits the deputy. Just behind the desk is a fancy cabinet, with real glass in the door. Next to the cabinet, a large, framed picture of the sheriff stands on the floor. To the side of the desk, there is a weird looking contraption: clearly, some sort of steam boiler which is connected by pipes to a strange looking machine. On the opposite side of the room, two swinging doors lead back to town. Flash's empty dog food bowl is nailed to the floor just in front of your jail cell.

Muddy leans against the wall.

You can also see a deputy here.

A repaired stool stands upright.

In the corner of the cell, a disheveled man in a black suit is stretched out on a crude wooden bench and is snoring loudly, oblivious to your presence.

In the jail cell you can also see a harmonica and a can of beans (in which is a spoon).

>hang picture
What do you want to hang the portrait on?

>hang portrait on wall
Muddy walks over to the portrait and hangs it on the wall, calling back to you, "Do this look centered?"

You regard the portait critically, "A little more to the left."

"Good?"

"A little more..."

"Now?"

"There. I'd say it's well-hung."

Muddy raises his eyebrows, but doesn't say anything.

>e
Muddy relents and says, "All right, Rick. I reckon we done what we can done. Let's make for the hills."

As you head out of the office, two men appear in the door way: Sheriff Cheney and Federal Marshal McLuhan. They are followed by a small detachment of U.S. Army guards.

Sheriff Cheney surges forward pointing his finger at you and Muddy, "It were these two what blown up that train tunnel! They's escaping when we walked in! Look, they done killed my deputy! We should drop 'em where they stand."

The marshal looks uncertain and waves the army guards forward, training their pistols on you. 

He rests his hand on the sheriff's trigger arm and says, "Sheriff, without any evidence to substantiate your accusation regarding the train robbery, I was reluctant to see these men hanged without a trial. Given the corpse of a lawman in front of us, though, even I have to agree that justice should be swift and definitive in this instance."

>wake deputy
Seeing the sheriff, the deputy sobers up immediately and jumps to his feet. "I was just resting my eyes for a moment, sir, and helping these gentlemen hang your portrait up."

The marshal looks confused and asks the deputy, "Hang up his portrait?"

"Well sure, mister marshal, sir. The sheriff done told me they was our welcome guests and that he wanted his picture hung up."

The marshal raises his eyebrows suspiciously, "You had federal suspects tidying up your office? Sheriff Cheney, I have to say that seems quite sloppy, and not in keeping with the public trust inherent in your position."

Muddy whispers, "Rick, we ain't got long. I reckon that marshal is someone what can be reasoned with."

>show patent to marshal
You show the patent to marshal, and intimate that the sheriff had extensive business plans, far beyond his his mandate as a public servant. 

The marshal flips through the patent for the sheriff's invention and looks at you questioningly.

"So?" he asks. "It seems like a clever enough invention, and I presume this work was not done on public time, or using town resources. I also would guess that he will need some big-time investors to put a plan like this into action, but I don't see anything wrong with that. The sheriff's a businessman pure and simple. There isn't anything more American than a man willing to make a profit, when the profit is there for the taking."

The marshal advises, "Citizens, I am required by federal law as it applies to the Territory to advise you that CAPITAL CHARGES have been filed against you, and summary execution will take place, unless evidence to the contrary can be brought to light."

The sheriff rolls his eyes, "For the sake of the all that's Holy, whyn't we shoot 'em dead right here?"

The marshal looks at Sheriff Cheney and answers, "Because some of us believe in maintaining some semblance of due process."

>show telegram to marshal
You show the telegram to Marshal McLuhan, telling him that he'll find the sheriff's stage coach full of stolen silver just behind the jail.

Sheriff Cheney wipes his brow nervously, "I forgot that's where we left that coach. I do reckon I'm always forgetting where I park. I was going to mention the silver as evidence any second now."

The marshal strokes his chin. "You're saying that the sheriff intended to abscond with these funds instead of turning them to state's evidence? Can you show me any additional evidence that would corroborate this grave accusation? I'm not inclined to distrust an officer of the law. It is true that the sheriff had some personal business concerns, but I have seen nothing to make me suspect that he was lacking for funds."

Muddy whispers, "We got to show that marshal something. I reckon maybe we could make up some kind of excuse or shift the blame, maybe."

>show receipt
Who all do you want to {command}?

>show receipt to marshal
You show the marshal the receipt and suggest that the sheriff is quite in debt, and might turn to illegal activities to pay it off. 

The marshal dispatches two guards to search behind the office, and when they return with corroboration about the stolen silver, the marshal instructs his guards to restrain and disarm the sheriff, concluding, "So, now it is clear. The sheriff took advantage of the railway incident to rob the train's silver himself in order to finance the development of his invention into a business. He framed these two itinerant laborers to shift the blame. No wonder he wanted them killed so quickly."

The marshal rips the gold star off the Sheriff Cheney's shirt and instructs the guards, "Place Mr. Cheney behind bars."

Pastor Pete yawns and walks out of the cell as the guards wrestle the sheriff past him. "I do reckon I slept like the dead last night. Thank you for a peaceful night, deputy," and he walks out the front door.

The marshal raises his eyebrows, but continues, "Deputy James Smith Bush, by the power invested in me as federal marshal of this district, I hereby promote you to Sheriff of the Town of Crawdad's Gulch. Congratulations." The newly appointed sheriff grins and shakes his hand. As the marshal pins the star on Jimbo's chest he advises, "James, you'll probably want to get yourself some deputies -- men you can trust."

Sheriff Jim looks over to you and Muddy. The color drains from Muddy's face.
[Your score has just gone up by five]

Sheriff Cheney walks behind the office desk and is alarmed to see that the drawer has been unlocked.

*** YOU WIN ***

Would you like to RESTART, RESTORE a saved game, see some suggestions for AMUSING things to do, or QUIT?

* * *

>þ
In the twilight, you sight the sheriff's sturdy brick office near the edge of town. "That's mighty fine construction," notes Muddy, sounding less feisty now. "Mighty fine indeed." The coach rolls to a halt and a thick arm yanks you roughly from your seat. You land awkwardly in the rutted street, where the sheriff holds you in place with the heel of one boot. He yells to his men, "Bring the coach on around, we got to impound that evidence." You are manhandled into the sheriff's office and shoved into a small holding cell.

The deputy wakes with a start, whips his dusty boots off the desk and stands, tucking his shirt back into his pants. The sheriff gives him a brief, judgmental glance and offhandedly tosses an arrest warrant on the desk. He barks, "Jimbo, listen up. Picked up these two down near the train. A federal marshal will be coming for them at eight o'clock tomorrow morning. There's going to be a hanging!". The deputy nods slowly. The sheriff continues, "Please take care of our 'guests'. I got to head down to Wichita Falls to discuss my invention with some investors, so you is in charge." The deputy smiles until the sheriff adds, "Jimbo, don't screw up," as he heads out the door.

Jail Cell
Why are you not surprised to have landed right back in the hoosegow after another one of Muddy's dubious plans? Will you ever learn? You weren't brought up for this sort of life -- how did it come to this? 

The small jail cell is brick on three sides, metal bars on the other, with a tightly locked gate.  A small window is set into the brickwork above your head.  Through the jail bars you can see the sheriff's office.

A broken stool lies on the floor.

In the corner of the cell, Muddy leans against the wall tapping a harmonica on his arm.

In the corner of the cell, a disheveled man in a black suit is stretched out on a crude wooden bench and is snoring loudly, oblivious to your presence.