As the sun sets on the plains, Sheriff Cheney angrily snaps on the cuffs. You are shoved into the coach and land on top of Muddy Charlie and a pile of  silver dollars, which until recently had been the property of the Missouri, Kansas & Texas Line.

Muddy whispers, "Don't fret none, Rick! You done good blowing up that tunnel -- I just didn't plan on the sheriff getting word ahead of time, is all. That were powerful bad luck."

The sheriff climbs onto his horse, spits, and you begin to rumble forward. "You boys really got it coming this time," he yells back cheerfully.

Muddy shakes his head. "No offense, Sheriff, but I reckon you got the wrong men. We was just on our way to the theater."

The sheriff disagrees. "The only place you boys are heading is straight to the... 

Hoosegow
A Wild West Wreck by Ben Collins-Sussman and Jack Welch
Release 1 / Serial number 100122 / Inform 7 build 5Z71 (I6/v6.31 lib 6/12N) SD
Type "help" for instructions and "hints" for hints -- or just roll into town guns a-blazin'.

[Press Space To Continue]

In the twilight, you sight the sheriff's sturdy brick office near the edge of town. "That's mighty fine construction," notes Muddy, sounding less feisty now. "Mighty fine indeed." The coach rolls to a halt and a thick arm yanks you roughly from your seat. You land awkwardly in the rutted street, where the sheriff holds you in place with the heel of one boot. He yells to his men, "Bring the coach around back, we got to impound that evidence." You are shoved into the sheriff's office and then into a small holding cell.

The deputy wakes with a start, whips his dusty boots off the desk and stands, tucking his shirt back into his pants. The sheriff gives him a brief, judgmental glance and offhandedly tosses an arrest warrant on the desk. He barks, "Jimbo, listen up. Picked up these two down near the train. A federal marshal will be coming for them at eight o'clock tomorrow morning. There's going to be a hanging!". The deputy nods slowly. The sheriff continues, "Please take care of our 'guests'. I got to head down to Wichita Falls to discuss my invention with some investors, so you is in charge." The deputy smiles until the sheriff adds, "Jimbo, don't screw up," as he heads out the door.

Jail Cell
Why are you not surprised to have landed right back in the hoosegow after another one of Muddy's dubious plans? Will you ever learn? You weren't brought up for this sort of life -- how did it come to this? 

The small jail cell is brick on three sides, metal bars on the other, with a tightly locked gate. A small window is set into the brickwork above your head. Through the jail bars you can see the sheriff's office.

A broken stool lies on the floor.

Muddy leans against the wall tapping a harmonica on his arm.

In the corner of the cell, a disheveled man in a black suit is stretched out on a crude wooden bench and is snoring loudly, oblivious to your presence.

>x bars
You look across the street at the saloon. Oh wait, did you mean the prison bars? Yeah, probably. Anyhow, the bars to your cell reach from floor to ceiling and are made of matte black metal. All except one, which is sort of gray in color. They are a bit under an inch thick, and they are reinforced by three tiers of horizontal bars. The gate to your cell is framed in the same black metal and inset into this meshwork of bars.

Muddy seems lost in thought.

>touch bars
The deputy looks up from the warrant, annoyed at the distraction. "Them jail bars is solid iron, boys. Now stop messing with them. I would surely hate to have to shoot you tonight and ruin tomorrow's hanging."

>g
The deputy shifts forward in his seat, "I done told you once, don't mess with the metal bars, not the jail bars, and not them rods in the window. It ain't like it's going to help you none anyhow, but it don't seem proper, what with me sitting here. Keep it up, and I may have to shoot some lead in your direction. That's a metaphor. It means, I'm going to have to shoot you, in case you don't know what a metaphor is. See. Lead is what's in bullets, so in this case, lead is a symbol for... um, lead. I can see I'm wasting my time explaining this to the likes of you."

>get bars
The deputy rubs his head with his palms and growls, "I'm a-warning you first instead of a-shooting you first because I got myself a bad headache and I don't need the extra noise. Keep messing with them jail bars and I will scratch my itchy trigger finger."

Muddy raises his eyebrows at you to get your attention and whispers, "He ain't kidding, Rick. We best not push him too far. He's  a rattlesnake in a bottle of tequila."

"What the blazes does that mean, Muddy?"

"Just metanymy, I reckon."

>g
Without bothering to get up from his comfortable position behind the desk, the deputy draws his mean-looking nine-shot LeMat revolver and squeezes off a lazy shot in your direction, only looking afterwards to see if he hit anything. "I said, stop messing around in there, or the vultures are going to dine early tonight."

>g
The deputy folds down his paper and leers at you, "Don't tempt me. I could do with some target practice."

Muddy shakes his head, motioning you back. "Rick, this guy's one stagecoach stop short of the fort, if you know what I mean. We best to find a way to get him out of the picture, or we ain't never going to get out of here."

>g
The deputy rolls his eyes, "You is about the dumbest, stupidist, most corn-starched spit-lickingest idiotic pie-brained goat-galooting criminals I did ever see."

He pulls his gun out from under the desk and uses it for punctuation, mainly of the ceiling. "Listen, you!" (Bang.) "When I said--" (bang) "--don't--" (bang) "--go messing--" (bang) "--with stuff--" (bang) "--I meant it." (Bang, bang.) "Now, do you understand me-- " (bang). The last bang rises slightly in pitch to convey that it was a question.

The bullets ricocheting off the jailhouse walls every which way are enough to shake up even Muddy, who hisses, "Stop messing with him Rick, the clock's ticking and we got to get out here by morning, or we'll be wearing hemp neckties for the rest of our lives. Rick, you got to figure us a way to get him out of here, so we can get busy with some proper jail-breaking."

>g
The deputy leaps up, this time angry, his face flushing. He stuffs the paper in his pocket and levels his gun at your head. "I had enough of you! (click)" He stares stupidly at his gun before realizing that he has to reload it. "Lucky for you, I reckon." He begins plucking bullets from his belt and loading them one by one into the cylinder. "You so much as sing, and I'll have to see to your killing."

A look of fear washes over Muddy's face, "Don't do it, Rick. Don't do it."

>sing
The deputy sighs, raises his gun and fires. You catch the bullet smack dab in forehead.

As the lights fade, Muddy bends over you and closes your eyes, whispering, "I ain't gonna give you up, I ain't gonna let you down..."

*** YOU'VE BEEN ROLLED, RICK ***

Would you like to RESTART, RESTORE a saved game, or QUIT?

* * *

>take harmonica
"I ain't never seen you play the mouth organ, Muddy."

Your partner turns the harmonica back and forth, and a chain rattles. "That's 'cuz I ain't never learned how," he replies.

Muddy hands the harmonica to you.

>play harmonica
You tentatively blow on it a bit, but you're not rightly sure what you're doing.

The deputy grimaces, "Knock off that racket, you two. A noise like that, a man can't get to thinking straight. Settle down now, you hear? I got me some reading to do." The deputy unfolds the warrant, furrows his brow and begins reading. You can tell because his lips are moving. Slowly.

>play harmonica
The deputy cringes, as you blow not only the notes that are built into the harmonica, but every note in between as well. He stands up, shoves the warrant into his pocket, and grabs a bottle of whiskey off the cabinet.

"I declare: that's just the worst thing I ever heard in my life. It's enough to drive a man to drink." To prove it, he takes a mighty swig from the whiskey bottle and wipes his mouth with the back of his sleeve. The deputy puts his fingers in his ears and tries to ignore you.

You keep playing.

The deputy balls his hands into fists and trembles with annoyance, "I'm going to the saloon to listen to some real music, from some real talented lady folk of the female persuasion." The deputy walks out the front door in a huff.

"You should hear me play piano," you remark, but he's already out of earshot.

[Your score has just gone up by one]

Muddy says, "Nice one.  Hey -- I reckon I saw that screw up there wiggle a bit when you played the harmonica. I didn't say nothing on account what the deputy was here."  He points to a screw holding in one of the cell bars.

>z
Time passes.

The deputy pokes his head back in the office and remarks, "I've about had enough of you characters. You can stew in your own juices here. I got important things to do over yonder in the saloon. But I reckon I would be dairy licked to leave you jokers alone."

The deputy grabs a dinner bell from the hook where it hangs next to the office door, and he rings the bell slowly a few times. Nothing happens. He rings it again. Minutes go by and the deputy waits impatiently. Finally, a fat bloodhound waddles leisurely through the door way, tempted by the dinner bell.

The deputy reaches into his pocket and retrieves a scrap of beef jerky. He pitches it into the dog's bowl and the bloodhound gobbles it down. The deputy leads his mangy old dog towards the office's strange looking steam boiler and ties him to it with a leash.

"This here's Flash, my hunting dog. I got to warn you that he can be vicious when he gets riled up, so don't cross him." Flash slowly slumps down next to the boiler, enjoying the heat. His heavy eyes close and drool drips from his toothless mouth.

"Flash here's apt to rip your throat out if you so much as look at him funny, but I got him hooked up here to the sheriff's fancy steam contraption." The deputy narrows his eyes distrustfully. "If you boys were so stupid as to make for the jailhouse door, 'ol Flash would yank that lever and set off the steam whistle on the roof. The sheriff installed it special for me, so as I can come when he wants me. I can hear that half way across town, and if'n I do hear it, then you'll have to deal with me *and* Flash." The deputy gives Flash one last pat on the head, swigs the whiskey one more time, and departs for the saloon.

>wait
Time passes.

Muddy picks some food from between his teeth. 

"That worked out well," says Muddy proudly.

"Yeah," you agree, "but my ears are still buzzing from that sound."

>look
Jail Cell
The small jail cell is brick on three sides, metal bars on the other, with a tightly locked gate. A small window is set into the brickwork above your head. Through the jail bars you can see the sheriff's office.

A broken stool lies on the floor.

Muddy leans against the wall.

In the corner of the cell, a disheveled man in a black suit is stretched out on a crude wooden bench and is snoring loudly, oblivious to your presence.

In the office you can see Flash.

* * *

>g
Those rods aren't going anywhere; at most, you can maybe reach your hand through them.

* * *

>wait
Time passes.

Muddy picks some food from between his teeth. 

"That worked out well," says Muddy proudly.

"Yeah," you agree, "but my ears are still buzzing from that sound."

>climb window
"Muddy, give me a hand up," you ask. Muddy stretches his back and boosts you up to the window.

>look out window
The jail is at the end of a long street. Directly across the street is a saloon, which is open, unlike the stores on both sides of the street that have pulled down their shades for the evening. Below the window there is a covered barrel; you can almost touch its top. Just to the left of the window, a berry-covered vine has grown up the side of the building. 

Up in the sky, you notice a couple of hungry, circling vultures.

Muddy stares out the window. 

Muddy shakes and quivers with effort. "Hanging in there for now, Rick," he adds, "but I wish they put that window down lower."

>get berry
You pluck a plump juicy red berry from the part of the vine growing outside the window.
[Your score has just gone up by one]

>wait
Time passes.

Muddy murmurs to himself about not being able to recall a limerick he once heard that had something to do with cowboys and farmers. 

Muddy trembles and jumps back. You fall to the floor. Muddy apologizes, "Sorry, Rick. My hands slipped."

>x barrel
You ain't able to see no such thing.

>climb window
Muddy knows the drill, and bends down to give you a boost, saying, "Go gentle. I got a bad back, you know. Age ain't kind to them that is in our profession, you know.".

>x barrel
It's a weathered oak barrel. You can't tell what inside it, if anything.

A yellow-fringed surrey trots past the sheriff's office.

Muddy shifts with a whimper. "I'm fine," he says, "but don't dally up there."

>wait
Time passes.

>wait
Time passes.

Muddy slips and you hop off, none the worse for the effort.

>x barrel
You ain't able to see no such thing.

>climb window
Muddy rubs his back but lifts you up.

>wait
Time passes.

Muddy grunts. "I hope you got a good view up there," he declares, "but there's got to be a better way of climbing up there."

>wait
Time passes.

>wait
Time passes.

"Ain't you gonna ask me about my plan?" Muddy whispers. 

"Timber!" yells Muddy, as his shaky grip fails and you once again plummet to the floor of the jail cell. "I think you just about done my back in that time, Rick."

>ask muddy about plan
"Let's keep this between us, though", he whispers.

He notices the sleeping man in your cell for the first time. "Don't know about him." Muddy jerks his thumb towards the sleeping figure. "Might be a spy."

Muddy leans towards you, his face barely an inch from your ear and his buzzard-worthy breath even less so from your nose. "Okay, Rick, I'm a-going to tell my plan." Muddy pauses dramatically. "Here it is: we got to break out of this jail before we get strunged up."

"That's it? That's your whole damn plan? That don't count as no plan!" you fume.

"Keep it down, Rick!" Muddy's gaze darts between the deputy and your third cellmate. "Yeah, that's it for now. It takes time to cook up a good plan. You need lots of ingredients."

"Muddy Charlie," you retort, "I heared you was the worst cook in the Confederate Army. Your cooking like as did more damage than Sherman's March."

Muddy gives you a hurt look and sulks in the corner. After a while, you regret being so quick-tempered with your old buddy.

>climb window
Muddy looks like his back hurts; he's walking kind of bent over now, but still gives you a boost up to the window.

>x barrel
It's a weathered oak barrel. You can't tell what inside it, if anything.

Muddy wonders if he would have had a better life as a dentist. "This might just work," he adds, "but why am I always the one doing the lifting? I guess on account of you is taller."

>wait
Time passes.

>wait
Time passes.

Muddy's grip fails and you drop. He shakes his head. "I ain't got it in me to do no more lifting, and I ain't fixing to do no climbing neither. Can you climb up on something else (besides me, that is)?"

>climb window
Those rods aren't going anywhere; at most, you can maybe reach your hand through them.

>g
Those rods aren't going anywhere; at most, you can maybe reach your hand through them.

Sorry citizen, I didn't hear you rightly. What?

>g
Those rods aren't going anywhere; at most, you can maybe reach your hand through them.

Muddy scratches his arm.

* * *

>purloin can of beans
[Purloined.]

>x can of beans
A closed metal can with a paper label saying "BEANS". On the back, some fine print says, "Precooked beans. No claim is made regarding the cardioprotective nature of this product. May cause abdominal distension if ingested. No fitness of purpose is implied. No warranty is provided for personal or other injury, or injury or loss related directly or indirectly to the use of this product. By opening this can, you agree to the terms of service posted in town."

Muddy rubs his eyes, "I didn't get a good night's sleep last night either. I'm bushed."

>show can of beans to muddy
Muddy grunts, unimpressed.

>show can of beans to deputy
The deputy isn't impressed.

>i
You're carrying a can of beans, your pocketwatch, and a scrap of paper. You are wearing your hat, pants, overcoat, left boot, and right boot. 

Your revolver was confiscated, it seems.

On the other side of the jail bars in the office, the deputy peeks through the jail cell window at the saloon across the street. It's clear he'd rather be there.

>show paper to muddy
Muddy takes a look at the scrap of paper and says, "That plan didn't work out too well, I'll admit."

Muddy looks like he's about to have a great idea, but then goes back to staring at the floor.

>show paper to deputy
The deputy looks irritated, but looks over at the scrap of paper and says, "Huh? I can't read that chicken scratch."

>show tin to deputy
(first taking the tin)
You borrow Pete's tin of chewing tobacco. It don't look like he'll mind seeing as how he's unconscious and all.

The deputy isn't impressed.

>show tin to muddy
Muddy grunts, unimpressed.

In the office, the deputy sniffles loudly and wipes his nose on his sleeve.

>restart
You sure you want to turn tail and restart?

* * *

>climb window
The deputy looks up from the warrant, annoyed at the distraction. "Them window rods is solid iron, boys. Now stop messing with them. I would surely hate to have to shoot you tonight and ruin tomorrow's hanging."

>g
The deputy shifts forward in his seat, "I done told you once, don't mess with the metal bars, not the jail bars, and not them rods in the window. It ain't like it's going to help you none anyhow, but it don't seem proper, what with me sitting here. Keep it up, and I may have to shoot some lead in your direction. That's a metaphor. It means, I'm going to have to shoot you, in case you don't know what a metaphor is. See. Lead is what's in bullets, so in this case, lead is a symbol for... um, lead. I can see I'm wasting my time explaining this to the likes of you."

* * *

>x boots
Black boots that have seen better days. The left boot is missing its heel spur.

Back in the office, the deputy sniffles loudly and wipes his nose on his sleeve.

>remove boot
Which all do you mean, the left boot, or the right boot?

>left
In some states that's a felony. Are you sure?

(yes or no) >

>yes
You rock back and forth on the floor, locked in a death struggle with your foot. Beads of sweat form on your head, as you struggle to twist and pull the boot off. With a sudden sucking pop, the boot relents and you tumble backwards.

Muddy's eyes water as he complains, "Ain't you got no sense of smell in that head of yours?"

To which you reply, "Not after I been downwind of you around feeding time, nope. This ain't nothing next to what you can do with a can of beans!"

The deputy wrinkles his nose in distaste and produces a fat cigar from his pocket. He reaches over to the office's steam boiler, lights the cigar, walks right up to the jail bars and blows the smoke directly into your face. The stench of the cigar is an even match for the reek of your feet.

>smell
The whole place reeks of cheap cigar smoke.

On the other side of the jail bars in the office, the deputy peeks through the jail cell window at the saloon across the street. It's clear he'd rather be there.

>remove boot
(the right boot)
There are people within a thousand yards. Are you sure?

(yes or no) >

>yes
You rock back and forth on the floor, locked in a death struggle with your foot. Beads of sweat form on your head, as you struggle to twist and pull the boot off. With a sudden sucking pop, the boot relents and you tumble backwards.

Muddy's eyes water as he complains, "Not again! My poor nose!"

The Deputy's cigar seems to shrivel and hang limply in his mouth, as its prodigious odor is astronomically outclassed by the combined stench of your two feet. Suppressing the urge to throw up from the smell, the deputy reaches over to the whiskey bottle and half drains it on his way out the door.

After he leaves, you give in to Muddy's desperate pleas to put your boots back on.

The fragrance gradually improves as the universe cools.

>smell
It stinks to high heaven.

A yellow-fringed surrey trots past the sheriff's office.

>z
Time passes.

The deputy pokes his head back in the office and remarks, "I've about had enough of you characters. You can stew in your own juices here. I got important things to do over yonder in the saloon. But I reckon I would be dairy licked to leave you jokers alone."

The deputy grabs a dinner bell from the hook where it hangs next to the office door, and he rings the bell slowly a few times. Nothing happens. He rings it again. Minutes go by, and the deputy waits impatiently. Finally, a fat bloodhound waddles leisurely through the door way, tempted by the dinner bell.

The deputy reaches into his pocket and retrieves a scrap of beef jerky. He pitches it into the dog's bowl and the bloodhound gobbles it down. The deputy leads his mangy old dog towards the office's strange looking steam boiler and ties him to it with a leash.

"This here's Flash, my hunting dog. I got to warn you that he can be vicious when he gets riled up, so don't cross him." Flash slowly slumps down next to the boiler, enjoying the heat. His heavy eyes close and drool drips from his toothless mouth.

"Flash here's apt to rip your throat out if you so much as look at him funny, but I got him hooked up here to the sheriff's fancy steam contraption." The deputy narrows his eyes distrustfully. "If you boys were so stupid as to make for the jailhouse door, 'ol Flash would yank that lever and set off the steam whistle on the roof. The sheriff installed it special for me, so as I can come when he wants me. I can hear that half way across town, and if'n I do hear it, then you'll have to deal with me *and* Flash." The deputy gives Flash one last pat on the head, swigs the whiskey one more time, and departs for the saloon.

* * *

>x stool
A small stool. It's three-legged by design, but two-legged in practice, hence its inability to stand upright. All of the paint has been worn off the seat by your illustrious predecessors who inhabited this cell. Those same occupants carved every square inch of the stool's seat with their initials. A small bronze plate has been nailed to the bottom of the stool. 

Back in the office, the deputy runs his hand through his sparse hair.

>x seat
The top of the wooden stool's seat is covered by intriguing initials, some old, some new. When you flip it over, it is immediately apparent that the stool is missing a leg. In its place, there is just an empty socket.

Over in the office, the deputy warms his hands near the boiler.

>hint
Some players may find the temptation to rely on hints overwhelming, and you may prefer to remove temptation by disabling hints for the rest of this game. If you do so, however, you will not be able to access the hints unless you restart. Do you wish to disable hints? >

>n
Okay - but if you change your mind later you can use the HINTS OFF command to disable hints.

 > Getting rid of the deputy

1/11: It's hard to get stuff done with that deputy in the office.

Press SPACE to return to the menu or H to reveal another hint.

* * *

 > Getting rid of the deputy
 > Getting rid of the deputy

>q
Jail Cell
The small jail cell is brick on three sides, metal bars on the other, with a tightly locked gate. A small window is set into the brickwork above your head. Through the jail bars you can see the sheriff's office.

A broken stool lies on the floor.

Muddy leans against the wall tapping a harmonica on his arm.

In the corner of the cell, a disheveled man in a black suit is stretched out on a crude wooden bench and is snoring loudly, oblivious to your presence.

>hit
What do you want to hit?

>hint
 > Getting rid of the deputy

>q
Jail Cell
The small jail cell is brick on three sides, metal bars on the other, with a tightly locked gate. A small window is set into the brickwork above your head. Through the jail bars you can see the sheriff's office.

A broken stool lies on the floor.

Muddy leans against the wall tapping a harmonica on his arm.

In the corner of the cell, a disheveled man in a black suit is stretched out on a crude wooden bench and is snoring loudly, oblivious to your presence.

>s stool
I only twigged your meaning as far as hankering to s.

>x stool
A small stool. It's three-legged by design, but two-legged in practice, hence its inability to stand upright. All of the paint has been worn off the seat by your illustrious predecessors who inhabited this cell. Those same occupants carved every square inch of the stool's seat with their initials. A small bronze plate has been nailed to the bottom of the stool.

>climb stool
The deputy folds down the warrant he is reading and smiles encouragingly, "Please, go ahead. The stool is stronger than it looks."

You sit down on the precariously balanced two-legged stool and subsequently find yourself face down on the dusty jail floor. Muddy helps you up and brushes you off. 

The deputy laughs himself hoarse. "I declare, that were powerful entertaining!" The deputy continues to chuckle to himself, even as he turns back to his newspaper, "I said, please go ahead, and he sits on it. That were rich. Maybe he'll try again."

>g
You teeter momentarily on the stool and then topple face first into the floor, like a blacksmith's hammer striking the anvil. This is getting old real fast now. 

The deputy shakes his head. "You done it again! You know what they say in Texas? I'm a-telling you. They says, "Fool me once, shame on - shame on you. Fool me - you can't get fooled again."

It feels cooler than it did last night.

>hint
 > Getting rid of the deputy
   Fixing the wobbly stool.

>q
Jail Cell
The small jail cell is brick on three sides, metal bars on the other, with a tightly locked gate. A small window is set into the brickwork above your head. Through the jail bars you can see the sheriff's office.

A broken stool lies on the floor.

Muddy leans against the wall tapping a harmonica on his arm.

In the corner of the cell, a disheveled man in a black suit is stretched out on a crude wooden bench and is snoring loudly, oblivious to your presence.

>hint
 > Getting rid of the deputy
   Fixing the wobbly stool.

>
   Getting rid of the deputy
 > Fixing the wobbly stool.
   Getting rid of the deputy
 > Fixing the wobbly stool.

1/8: With only two legs, the stool is not usable.

Press SPACE to return to the menu or H to reveal another hint.

>h
1/8: With only two legs, the stool is not usable.

2/8: If you look at the seat, you'll see that something is missing.

Press SPACE to return to the menu or H to reveal another hint.

>h
1/8: With only two legs, the stool is not usable.

2/8: If you look at the seat, you'll see that something is missing.

3/8: The stool is missing a leg. It would be nice to find a replacement.

Press SPACE to return to the menu or H to reveal another hint.

>h
1/8: With only two legs, the stool is not usable.

2/8: If you look at the seat, you'll see that something is missing.

3/8: The stool is missing a leg. It would be nice to find a replacement.

4/8: Have you EXAMINEd the seat of the stool?

Press SPACE to return to the menu or H to reveal another hint.

>h
1/8: With only two legs, the stool is not usable.

2/8: If you look at the seat, you'll see that something is missing.

3/8: The stool is missing a leg. It would be nice to find a replacement.

4/8: Have you EXAMINEd the seat of the stool?

5/8: On the bottom surface of the seat there is a socket.

Press SPACE to return to the menu or H to reveal another hint.

>h
1/8: With only two legs, the stool is not usable.

2/8: If you look at the seat, you'll see that something is missing.

3/8: The stool is missing a leg. It would be nice to find a replacement.

4/8: Have you EXAMINEd the seat of the stool?

5/8: On the bottom surface of the seat there is a socket.

6/8: You need to put a substitute leg in the socket to fix the stool.

Press SPACE to return to the menu or H to reveal another hint.

>h
1/8: With only two legs, the stool is not usable.

2/8: If you look at the seat, you'll see that something is missing.

3/8: The stool is missing a leg. It would be nice to find a replacement.

4/8: Have you EXAMINEd the seat of the stool?

5/8: On the bottom surface of the seat there is a socket.

6/8: You need to put a substitute leg in the socket to fix the stool.

7/8: You have not yet found the substitute leg.

Press SPACE to return to the menu or H to reveal another hint.

>h
1/8: With only two legs, the stool is not usable.

2/8: If you look at the seat, you'll see that something is missing.

3/8: The stool is missing a leg. It would be nice to find a replacement.

4/8: Have you EXAMINEd the seat of the stool?

5/8: On the bottom surface of the seat there is a socket.

6/8: You need to put a substitute leg in the socket to fix the stool.

7/8: You have not yet found the substitute leg.

8/8: One of the jail bars is different from the others. You can use sound to help find the one that you need.

Press SPACE to return to the menu.

   Getting rid of the deputy
 > Fixing the wobbly stool.
   Getting rid of the deputy
 > Fixing the wobbly stool.

* * *

>x bench
A long wood bench made of rough, splintery planks. Under the bench, you notice the remnants of a meal.

>x meal
On closer inspection, it looks like a rancid piece of meat, a metallic can and a spoon.

The deputy has been watching you out of the corner of his eye and he smiles sardonically. "I see you found your dinner. Or was that last week's dinner? Har, har!"

>take can
Fetched.

Muddy stares out the window.

>take spoon
Fetched.

Muddy pats down his wild hair but only makes it worse.

>x can
A closed metal can with a paper label saying "BEANS". On the back, some fine print says, "Precooked beans. No claim is made regarding the cardioprotective nature of this product. May cause abdominal distension if ingested. No fitness of purpose is implied. No warranty is provided for personal or other injury, or injury or loss related directly or indirectly to the use of this product. By opening this can, you agree to the terms of service posted in town."

>x boots
Black boots that have seen better days. The left boot is missing its heel spur.

>x right boot
A cowhide boot that has been rubbed smooth. A metal riding spur is about ready to fall off the worn-down heel.

>take spur
You yank the spurs off your right boot, careful not to cut yourself in the process.

>open can with spur
Muddy cranes his neck to see what you're doing. He's never seen someone open a can with heel spurs. You slide the spur into the groove along the top of the can, and wiggle it back and forth. The can revolves, and the lid is nearly sawn off. It is hard to tell which of you is more surprised that this worked. 

[Your score has just gone up by five]

>eat beans
When you were a child, you remember visiting your cousins, who all liked beans. Your aunt insisted that if they could eat beans, so could you. You choked on them, and coughed them up, and they made fun of you. Since then, you don't even like the way they smell. The beans, that is. Actually, your cousins are kind of rank too.

Nonetheless, your stomach is growling and you could do with a meal.

[You have dealt with a repressed childhood memory in a constructive manner, your score just went up by two points]

Over in the office, the deputy warms his hands near the boiler.

>eat beans
The beans disgust you even more than the rancid meat.

[The thought is enough to make you lose a point.]

>eat beans
No. It's a matter of principle now.

[Your score just went back up by a point for being so principled.]

On the other side of the jail bars in the office, the deputy repeatedly counts his fingers, but is unable to get a firm answer.

>eat beans
Give Muddy the damn beans. He likes them, but you can't stand to even look at them.

>give beans to muddy
Muddy takes the can and stares hungrily at the beans.

Even in the most dire situation, Muddy's appetite remains intact. He looks expectantly at you and says, "Rick, got a spoon?"

>give spoon to muddy
Muddy cracks a gap-toothed smile and says, "Much obliged," before digging into the can of beans like a miner hot on a fresh gold vein. A couple moments later, he finishes circling the inside of the can with the spoon, trying to get every last drop of bean juice into his mouth. Afterwards, he places the can and spoon on the floor and rubs his stomach with satisfaction.

Muddy has an aura of well-fed contentment.

>z
Time passes.

Muddy holds his belly and comments, "Got a bit of indigestion, I does."

>z
Time passes.

Muddy wraps his arms around his belly, and moans softly, "I might have overdone it with them beans."

The deputy looks up from his reading, curious. 

"Ain't you gonna ask me about my plan?" Muddy whispers.

>z
Time passes.

Muddy doubles over, "Rick, you should get to high ground. I'm feeling a mite bloated after them beans, and I think you know what's coming!"

"Where the Sam Hill do you think I'm going to run to, Muddy? We're locked up in a hoosegow! Deputy, if'n I was you, I would put some distance between Muddy and your nose. "

The Deputy looks concerned, but confused. 

"This time my plan is sure fire -- go ahead, ask me. C'mon." Muddy jibes quietly.

>z
Time passes.

You hear nothing. The smell nearly knocks you out. Vision fades, the room spins.

Muddy whispers in that understated manner of his, "That were a silent but deadly."

"Ain't you even a speck curious to ask me about my plan?" taunts Muddy.

>z
Time passes.

Suppressing the urge to throw up from the smell, the deputy reaches over to the whiskey bottle and half drains it on his way out the door.

The fragrance gradually improves as the universe cools.
[Your score has just gone up by one]

"Truthful, Rick," whispers Muddy solemnly, "this ain't like all my other plans, this one is iron-clad. Ask me about it. Go ahead." 

Muddy looks around the sheriff's office.

>z
Time passes.

Muddy vibrates with excitement and gushes, "I got to tell you, Rick, or this new plan of mine is going to drive me plumb crazy!" 

"Let's keep this between us, though", he whispers.

He notices the sleeping man in your cell for the first time. "Don't know about him." Muddy jerks his thumb towards the sleeping figure. "Might be a spy."

Muddy leans towards you, his face barely an inch from your ear and his buzzard-worthy breath even less so from your nose. "Okay, Rick, I'm a-going to tell my plan." Muddy pauses dramatically. "Here it is: we got to break out of this jail before we get strunged up."

"That's it? That's your whole damn plan? That don't count as no plan!" you fume.

"Keep it down, Rick!" Muddy's gaze darts between the deputy and your third cellmate. "Yeah, that's it for now. It takes time to cook up a good plan. You need lots of ingredients."

"Muddy Charlie," you retort, "I heared you was the worst cook in the Confederate Army. Your cooking like as did more damage than Sherman's March."

Muddy gives you a hurt look and sulks in the corner. After a while, you regret being so quick-tempered with your old buddy.

>z
Time passes.

A fly buzzes past your ear and lands on the ceiling.

The deputy pokes his head back in the office and remarks, "I've about had enough of you characters. You can stew in your own juices here. I got important things to do over yonder in the saloon. But I reckon I would be dairy licked to leave you jokers alone."

The deputy grabs a dinner bell from the hook where it hangs next to the office door, and he rings the bell slowly a few times. Nothing happens. He rings it again. Minutes go by and the deputy waits impatiently. Finally, a fat bloodhound waddles leisurely through the door way, tempted by the dinner bell.

The deputy reaches into his pocket and retrieves a scrap of beef jerky. He pitches it into the dog's bowl and the bloodhound gobbles it down. The deputy leads his mangy old dog towards the office's strange looking steam boiler and ties him to it with a leash.

"This here's Flash, my hunting dog. I got to warn you that he can be vicious when he gets riled up, so don't cross him." Flash slowly slumps down next to the boiler, enjoying the heat. His heavy eyes close and drool drips from his toothless mouth.

"Flash here's apt to rip your throat out if you so much as look at him funny, but I got him hooked up here to the sheriff's fancy steam contraption." The deputy narrows his eyes distrustfully. "If you boys were so stupid as to make for the jailhouse door, 'ol Flash would yank that lever and set off the steam whistle on the roof. The sheriff installed it special for me, so as I can come when he wants me. I can hear that half way across town, and if'n I do hear it, then you'll have to deal with me *and* Flash." The deputy gives Flash one last pat on the head, swigs the whiskey one more time, and departs for the saloon.

>x man
The man crumpled in the corner appears to be wearing a black suit and a pastor's neck tie. He'd almost look respectable, if it weren't for the immediate environment. He reeks of booze and snores loudly. A pamphlet is sticking out of his pocket. You don't consider yourself a common pickpocket, but it makes you wonder what else he might have on him.

"Ain't you even a speck curious to ask me about my plan?" taunts under his breath Muddy. 

"That worked out well," says Muddy proudly.

"For you maybe," you reply. "But I near as lost my lunch what with that stench."

To which Muddy counters, "Ain't much worse than your feet, I reckon."

>take pamphlet
You carefully slip the pamphlet out of the sleeping man's pocket.  He almost wakes up, but doesn't.

"Whatizit?", Muddy rasps.

"Truthful, Rick," whispers Muddy solemnly, "this ain't like all my other plans, this one is iron-clad. Ask me about it. Go ahead." 

Flash lazily sniffs the desk.

>x pamphlet
The pamphlet depicts God in a cowboy hat roasting sinners over a camp fire. A sermon is printed below the picture.

Muddy vibrates with excitement and gushes, "I got to tell you, Rick, or this new plan of mine is going to drive me plumb crazy!" 

"Let's keep this between us, though", he whispers.

He notices the sleeping man in your cell for the first time. "Don't know about him." Muddy jerks his thumb towards the sleeping figure. "Might be a spy."

Muddy leans towards you, his face barely an inch from your ear and his buzzard-worthy breath even less so from your nose. "Okay, Rick, I'm a-going to tell my plan." Muddy pauses dramatically. "Here it is: we got to break out of this jail before we get strunged up."

"That's it? That's your whole damn plan? That don't count as no plan!" you fume.

"Keep it down, Rick!" Muddy's gaze darts between the deputy and your third cellmate. "Yeah, that's it for now. It takes time to cook up a good plan. You need lots of ingredients."

"Muddy," you retort, "I heared you was the worst cook in the Confederate Army. Your cooking like as did more damage than Sherman's March."

Muddy gives you a hurt look and sulks in the corner. After a while, you regret being so quick-tempered with your old buddy.

>read pamphlet
You read it aloud:

"The Prairie Gospel Church of Uncanny Righteousness"

"For lo, the impetuous and retributive spirit of FINAL JUDGEMENT is stirring in the heart of the unfaithful, and a FIERY thunderhead of retribution is gathering across the plains of the undeserving, the bereft of propriety, and promulgators of heresy, and the scalding hot sparks of TRUTH are spraying forth, catching light the arid and HIGHLY FLAMMABLE and veritably kerosene-soaked sawdust of the weak-willed. And into this fray, the unwholesome BEAST shall arise and the earth shall tremble. Its body shall tower above like a mountain, and upon the body shall be nineteen heads, each like unto a serpent. Upon each head, twelve horns, like that of the ram, the bull, and the elephant, say four of each. And upon each horn, sixteen stalks, not unlike celery in some respects, yet more flexible, more like the arms of an octopus, except being twice as numerous. And upon each stalk, eighty eyes, or forty pairs of eyes, if you prefer!"

Muddy, who had been staring intently at his boot tips looks up, eye brows knit in concentration. "Ah don't get it. Why would anything need two hundred ninety-one thousand, eight hundred and forty eyes?"

"What?" you remark, looking up from the pamphlet. "Are you kidding me? How could you figure that out?"

"Don't rightly know. Just something I do. Same way as I know there's 69,105 railroad ties between here and Muskogee. Ma said I was some kind of idiot savage."

Dumbfounded, you stop reading halfway through the pamphlet to stare incredulously at Muddy, who picks his nose. "Yeah, go on. What else's it say?"

>read pamphlet
You straighten out the pamphlet and skim it, paraphrasing for Muddy.

"Well let's see. It keeps going on like that for a ways without really saying much. By and by there's this part about a revival meeting. Some kind of doxology works, but out in the open, like under a circus tent. It says they'll be some preaching, some healing and even some dancing. I'd allow it sounds like a right pleasant shindig, it do."

Muddy pauses. "Can I see that pamphlet a minute?"

>give pamphlet to muddy
Muddy grabs it from you, squinting and sounding out words silently with his mouth. His eyes open wide in amazement.

"Pete? Wait a gosh darn... PASTOR Pete? That really him? Hot diggity!"

Muddy jumps to his feet, runs to the bench and shakes Pete wildly; Pete screams and throws his hands into the air, gesticulating to heaven as he's awoken from his dream --

"BEGONE, devils! God shall SMITE thee! He who brushes the Lord's horses shall not clean the stables of HEAVEN!"

The grubby preacher collapses back on the bench, eyes closed and snoring before either of you can take a step.

>search pete
You find a tin of chewing tobacco. It looks interesting, so you borrow it.

Flash stands up, turns around once, and lays back down again.

>i
You're carrying a tin, a pamphlet, a spur, your pocketwatch, and a scrap of paper. You are wearing your hat, pants, overcoat, left boot, and right boot.

>open tin
You open the tin, revealing a wad of tobacco.

Flash is as still as a statue.

>read tin
A rectangular tin of "Spitting Image" chewing tobacco. The cover shows a cowboy painting a portrait of an Indian, and true to its name, the image on the canvas looks just like the Indian. The tin is opened revealing some shredded black chewing tobacco.

A cockroach scrambles by, making a detour around Muddy. Cockroaches have noses, you figure.

>x tin
A rectangular tin of "Spitting Image" chewing tobacco. The cover shows a cowboy painting a portrait of an Indian, and true to its name, the image on the canvas looks just like the Indian. The tin is opened revealing some shredded black chewing tobacco.

Muddy spends some time looking over at the desk in the office.

>chew tobacco
(first sticking some in your maw)
The tobacco is getting juicy and soft.

It feels cooler than it did last night.

>chew tobacco
It tastes pretty horrid.

>chew tobacco
You wonder if tobacco is really good for you, like the doctors say.

Muddy murmurs to himself about not being able to recall a limerick he once heard that had something to do with cowboys and farmers.

>chew tobacco
The taste of the tobacco is beginning to disgust you. You'd like to get it out of your mouth.

>spit tobacco at bell
Ding! The bell is hit so hard that it spins around on the hook several times, clanging like a church bell on Sunday.

The ameoba-like mass of fat and fur known to you as Flash leaps immediately to his feet, saliva dripping from his toothless jowls. He lunges like a champion fencer for his food bowl. His leash snaps taut, pulling the lever away from the front door and towards the strange machine.

The boiler hisses and gurgles, steam jets from the rivet joints in the pipe that connects to the machine, and the machine itself vibrates and rumbles for a minute. A white cup drops from a chute and brown liquid squirts from a nozzle and fills the cup. The smell of fresh coffee pervades the office.

Finding no food in his bowl, Flash huffs perfunctorily and resumes his former position, pulling the lever back to the middle position.

* * *

>ask muddy about plan
I already done told you -- we got to bust out.

"That worked out well," says Muddy proudly.

"For you maybe," you reply. "But I near as lost my lunch what with that stench."

To which Muddy counters, "Ain't much worse than your feet, I reckon."

>take harmonica
"I ain't never seen you play the mouth organ, Muddy."

Your partner turns the harmonica back and forth, and a chain rattles. "That's 'cuz I ain't never learned how," he replies.

Muddy hands the harmonica to you.

>play harmonica
Tentatively, you blow a few notes. The bars in the jail cell rattle sympathetically.

"Look at that, boy", Muddy laughs, "I swear that screw up there holding that bar is wiggling loose!"

Flash has a nightmare and growls quietly before returning to a deep slumber.

>play harmonica
Again, the room resonates with the rich and vibrant tones of a bagpipe connected to the blowhole of a baluga whale.

Muddy points excitedly towards the top of the gray bar, "When you played, that screw worked its way out more. It's like you got some kind of sonic screwdriver or something! I think one more time will do it."

Flash drools.

>play harmonica
The screw vibrates out of the ceiling, rebounds in a shower of sparks off the concrete floor of the jail cell rolls under the deputy's desk.   A gray bar falls loose from the ceiling and lands at your feet.

"You done it!" shouts Muddy.

>take bar
(the gray bar)
You hold it lengthwise and stare down its hollow shaft at Muddy. He looks back at you.  "Don't that just beat all," ponders Muddy.
[Your score has just gone up by one]

>put bar in socket
(the gray bar in the socket)
You flip the stool over and wiggle the hollow gray tube into the empty socket. It fits perfectly and remains in place when you let go of the bar, but you think you could yank the gray bar out again if you needed it. You now have a stool with three even legs: two wood, one metal.

Muddy cracks his knuckles loudly.

>stand on stool
Muddy holds it steady as you climb up. Your head is now even with the top of the window.

Jail Cell (on the stool)
The small jail cell is brick on three sides, metal bars on the other, with a tightly locked gate. A small window is set into the brickwork above your head. Through the jail bars you can see the sheriff's office.

Muddy leans against the wall.

In the corner of the cell, a disheveled man in a black suit is stretched out on a crude wooden bench and is snoring loudly, oblivious to your presence.

You can also see a can of beans (in which is a spoon) and a hunk of meat here.

In the office you can see Flash.

>look out window
The jail is at the end of a long street. Directly across the street is a saloon, which is open, unlike the stores on both sides of the street that have pulled down their shades for the evening. Below the window there is a covered barrel; you can almost touch its top. Just to the left of the window, a berry-covered vine has grown up the side of the building. 

Up in the sky, you notice a couple of hungry, circling vultures.

>x vine
The leafless tip of a wiry vine pokes into the cell through the window. It's covered with small red berries.

>take berry
You pluck a plump juicy red berry from the part of the vine growing outside the window.
[Your score has just gone up by one]

>put berry in bar
(the gray bar)
You drop the berry into the gray bar.

"Oh, I get it!" nods Muddy, "You're making some kind of berry gun. I seen the Injuns do something like that, except you ain't got no darts in there to blow at people."

>blow berry at bell
Ding! The bell is hit so hard that it spins around on the hook several times, clanging like a church bell on Sunday.

The ameoba-like mass of fat and fur known to you as Flash leaps immediately to his feet, saliva dripping from his toothless jowls. He lunges like a champion fencer for his food bowl. His leash snaps taut, pulling the lever away from the front door and towards the strange machine.

The boiler hisses and gurgles, steam jets from the rivet joints in the pipe that connects to the machine, and the machine itself vibrates and rumbles for a minute. A white cup drops from a chute and brown liquid squirts from a nozzle and fills the cup. The smell of fresh coffee pervades the office.

Finding no food in his bowl, Flash huffs perfunctorily and resumes his former position, pulling the lever back to the middle position.
[Your score has just gone up by one]

>get berry
You pluck a plump juicy red berry from the part of the vine growing outside the window.

>put berry in bar
(the gray bar)
You drop the berry into the gray bar.

>blow berry at coffee
The berry splatters against the side of the cup, and its juice drips into the steaming brew.

Muddy jumps up, claps you congratulatorily on the back, and you nearly swallow the metal tube still held to your lips.

He beams, "That were a one in a million shot, Rick!"  Muddy strokes his chin and wags a finger at the coffee, "Now, if we can only get the deputy to come back and drink that coffee, he might be a whole lot more cooperative, I reckon."

You sure like the way Muddy thinks.
[Your score has just gone up by one]

>take off left shoe
You ain't able to see no such thing.

>take off left boot
There are people within a thousand yards. Are you sure?

(yes or no) >

>yes
You rock back and forth on the floor, locked in a death struggle with your foot. Beads of sweat form on your head, as you struggle to twist and pull the boot off. With a sudden sucking pop, the boot relents and you tumble backwards.

Muddy's eyes water as he complains, "Ain't you got no sense of smell in that head of yours?"

To which you reply, "Not after I been downwind of you around feeding time, nope. This ain't nothing next to what you can do with a can of beans!"

Flash wakes with a start and sneezes loudly. The fur on his back bristles and he opens his eyes to stare in horror at your feet. He backs away, towards the front door. The leash pulls taut. He seems caught in the balance between an urge to run away from your stinky foot and his own laziness which holds him to the spot.

>take off right boot
In some states that would be a felony. Are you sure?

(yes or no) >

>yes
You rock back and forth on the floor, locked in a death struggle with your foot. Beads of sweat form on your head, as you struggle to twist and pull the boot off. With a sudden sucking pop, the boot relents and you tumble backwards.

Muddy's eyes water as he complains, "Not again! My poor nose!"

One foot was bad enough, but two is more than the old dog can handle. Trying not to sniff the air, flash turns tail and breaks for the door, straining against his leash which is tied to the steam pipe lever. The lever swings towards the door, and from the roof you hear the ear-splitting drone of a railway steam whistle.

You agree with with Muddy that the deputy is not likely to be in a good mood when he arrives, so you put your boots back on.

>z
Time passes.

The Deputy slams through the swinging doors to the office, lurching to the side as he struggles to put his other leg into his pants. He is bare-chested and empty handed, aside from a nearly empty bottle of whiskey. Flash is so scared that yanks the leash and snaps the lever clear off the machine.

The deputy thunders, "What the hoot-hollering blazes is the matter here?" The deputy surveys the office quickly and then rattles the gate to make sure it is still locked. In his drunk rage, he doesn't notice the missing metal bar. 

"Dumb dog," he mumbles, "I was doing important business." He looks around for Flash, but the dog has already slid out of the office. The deputy shakes his head in frustration and leaves the office.

The deputy brightens. "Ummm. I do smell me some coffee." The deputy drains the mug with a single gulp. "That's good. I got to wake me up some."

Almost immediately, the deputy spins on his heel and drops to the floor just in front of your jail cell.
[Your score has just gone up by one]

>x deputy
You are relieved to find that the deputy is unconscious, but breathing. He is wearing only a pair of pants -- no shirt, no gun belt, no boots.

* * *

>put berry in bar
(the gray bar)
You drop the berry into the gray bar.

>take off left boot
Oh, you really don't want to do that. Not indoors at least. Are you sure?

(yes or no) >

>yes
You rock back and forth on the floor, locked in a death struggle with your foot. Beads of sweat form on your head, as you struggle to twist and pull the boot off. With a sudden sucking pop, the boot relents and you tumble backwards.

Muddy's eyes water as he complains, "Ain't you got no sense of smell in that head of yours?"

To which you reply, "Not after I been downwind of you around feeding time, nope. This ain't nothing next to what you can do with a can of beans!"

Flash wakes with a start and sneezes loudly. The fur on his back bristles and he opens his eyes to stare in horror at your feet. He backs away, towards the front door. The leash pulls taut. He seems caught in the balance between an urge to run away from your stinky foot and his own laziness which holds him to the spot.

>take off right boot
There are people within a thousand yards. Are you sure?

(yes or no) >

>yes
You rock back and forth on the floor, locked in a death struggle with your foot. Beads of sweat form on your head, as you struggle to twist and pull the boot off. With a sudden sucking pop, the boot relents and you tumble backwards.

Muddy's eyes water as he complains, "Not again! My poor nose!"

One foot was bad enough, but two is more than the old dog can handle. Trying not to sniff the air, flash turns tail and breaks for the door, straining against his leash which is tied to the steam pipe lever. The lever swings towards the door, and from the roof you hear the ear-splitting drone of a railway steam whistle.

You agree with with Muddy that the deputy is not likely to be in a good mood when he arrives, so you put your boots back on.

>z
Time passes.

The Deputy slams through the swinging doors to the office, lurching to the side as he struggles to put his other leg into his pants. He is bare-chested and empty handed, aside from a nearly empty bottle of whiskey.

The deputy thunders, "What the cluster chucking blazes is the matter here?" The deputy surveys the office quickly and then rattles the gate to make sure it is still locked. In his drunk rage, he doesn't notice the missing metal bar. 

Satisfied that you haven't escaped, he pushes the lever back to the middle position and warns, "I don't know what you were up to what made old Flash trigger-happy, but don't let it happen again.""Dumb dog," he mumbles, "I was doing important business." The deputy waves his fist at you and leaves the office.

The deputy brightens. "Ummm. I do smell me some coffee." The deputy drains the mug with a single gulp. "That's good. I got to wake me up some."

The deputy looks at the two of you.  "Enough is enough.  You jokers stay put, I'll be back again in a bit."

The deputy watches Flash slink back into the office before sauntering out again.

>l
Jail Cell (on the stool)
The small jail cell is brick on three sides, metal bars on the other, with a tightly locked gate. A small window is set into the brickwork above your head. Through the jail bars you can see the sheriff's office.

Muddy leans against the wall.

In the corner of the cell, a disheveled man in a black suit is stretched out on a crude wooden bench and is snoring loudly, oblivious to your presence.

You can also see a can of beans (in which is a spoon) and a hunk of meat here.

On the machine is a cup (in which are a cup of coffee).

In the office you can also see Flash.

>blow berry at coffee
The berry splatters against the side of the cup, and its juice drips into the steaming brew.

Muddy jumps up, claps you congratulatorily on the back, and you nearly swallow the metal tube still held to your lips.

He beams, "That were a one in a million shot, Rick!"  Muddy strokes his chin and wags a finger at the coffee, "Now, if we can only get the deputy to come back and drink that coffee, he might be a whole lot more cooperative, I reckon."

You sure like the way Muddy thinks.
[Your score has just gone up by one]

>remove left boot
Oh, you really don't want to do that. Not indoors at least. Are you sure?

(yes or no) >

>yes
You rock back and forth on the floor, locked in a death struggle with your foot. Beads of sweat form on your head, as you struggle to twist and pull the boot off. With a sudden sucking pop, the boot relents and you tumble backwards.

Muddy's eyes water as he complains, "Man, them feets of yours stinks powerful bad!"

Flash wakes with a start and sneezes loudly. The fur on his back bristles and he opens his eyes to stare in horror at your feet. He backs away, towards the front door. The leash pulls taut. He seems caught in the balance between an urge to run away from your stinky foot and his own laziness which holds him to the spot.

>remove right boot
There are people within a thousand yards. Are you sure?

(yes or no) >

>yes
You rock back and forth on the floor, locked in a death struggle with your foot. Beads of sweat form on your head, as you struggle to twist and pull the boot off. With a sudden sucking pop, the boot relents and you tumble backwards.

Muddy's eyes water as he complains, "Man, them feets of yours stinks powerful bad!"

One foot was bad enough, but two is more than the old dog can handle. Trying not to sniff the air, flash turns tail and breaks for the door, straining against his leash which is tied to the steam pipe lever. The lever swings towards the door, and from the roof you hear the ear-splitting drone of a railway steam whistle.

You agree with with Muddy that the deputy is not likely to be in a good mood when he arrives, so you put your boots back on.

>z
Time passes.

The Deputy slams through the swinging doors to the office, lurching to the side as he struggles to put his other leg into his pants. He is bare-chested and empty handed, aside from a nearly empty bottle of whiskey. Flash is so scared that yanks the leash and snaps the lever clear off the machine.

The deputy thunders, "What the cow-poking sheep-sheering bear-baiting turkey-trotting blazes is the matter here?" The deputy surveys the office quickly and then rattles the gate to make sure it is still locked. In his drunk rage, he doesn't notice the missing metal bar. 

"Dumb dog," he mumbles, "I was doing important business." He looks around for Flash, but the dog has already slid out of the office. The deputy checks the gate again and leaves the office.

The deputy brightens. "Ummm. I do smell me some coffee." The deputy drains the mug with a single gulp. "That's good. I got to wake me up some."

Almost immediately, the deputy spins on his heel and drops to the floor just in front of your jail cell.
[Your score has just gone up by one]

>get off
Which way? West to the jail cell, or east towards the open range?

>l
Jail Cell (on the stool)
The small jail cell is brick on three sides, metal bars on the other, with a tightly locked gate. A small window is set into the brickwork above your head. Through the jail bars you can see the sheriff's office.

Muddy leans against the wall.

In the corner of the cell, a disheveled man in a black suit is stretched out on a crude wooden bench and is snoring loudly, oblivious to your presence.

You can also see a can of beans (in which is a spoon) and a hunk of meat here.

In the office you can see a deputy.

>get off stool
You jump down to the ground again.

Jail Cell
The small jail cell is brick on three sides, metal bars on the other, with a tightly locked gate. A small window is set into the brickwork above your head. Through the jail bars you can see the sheriff's office.

A repaired stool stands upright.

Muddy leans against the wall.

In the corner of the cell, a disheveled man in a black suit is stretched out on a crude wooden bench and is snoring loudly, oblivious to your presence.

You can also see a can of beans (in which is a spoon) and a hunk of meat here.

In the office you can see a deputy.

>get meat
Yuck. You are holding the rancid meat.

Fetched.

>get on stool
Muddy holds it steady as you climb up. Your head is now even with the top of the window.

Jail Cell (on the stool)
The small jail cell is brick on three sides, metal bars on the other, with a tightly locked gate. A small window is set into the brickwork above your head. Through the jail bars you can see the sheriff's office.

Muddy leans against the wall.

In the corner of the cell, a disheveled man in a black suit is stretched out on a crude wooden bench and is snoring loudly, oblivious to your presence.

You can also see a can of beans (in which is a spoon) here.

In the office you can see a deputy.

>put meat on barrel
The hunk of meat drops on top of the covered barrel that is just beneath the window. Almost immediately, a vulture drops from the sky, lands on the barrel, and begins tearing into the rancid meat.

>x vulture
A scrawny black bird, with a bald head, sharp yellow beak and white-tipped tail feathers. Its head is plunged into the putrifying piece of meat on the barrel, and tail waves provocatively in your face, just below the window.

>x tail
The vulture's tail plumage consists of several long, black feathers with white stripes.

>take feather
You pluck a feather from the vulture's tail, and it twists its head momentarily to glare at you before plunging back to its task of devouring the rotting meat.
[Your score has just gone up by one]

>take berry
You pluck a plump juicy red berry from the part of the vine growing outside the window.

>search deputy
You rifle through his pants pockets and find a federal warrant. You also find a small brass key. Naturally, you take both.

>get off stool
You jump down to the ground again.

Jail Cell
The small jail cell is brick on three sides, metal bars on the other, with a tightly locked gate. A small window is set into the brickwork above your head. Through the jail bars you can see the sheriff's office.

A repaired stool stands upright.

Muddy leans against the wall.

In the corner of the cell, a disheveled man in a black suit is stretched out on a crude wooden bench and is snoring loudly, oblivious to your presence.

You can also see a can of beans (in which is a spoon) here.

In the office you can see a deputy.

>open gate with key
(the gate with the small brass key)
The key is way too small to fit the medieval lock which imprisons you.

>x warrant
A piece of paper with black printing and red handwriting.

>read warrant
"Muddy, this here's a federal warrant!"

"What's it say, Rick?"

I'm a-reading it now: FEDERAL WARRANT. This warrant is issued this eleventh day of December in the year of Our Lord Eighteen Hundred and Seventy-One and duly executed by the hand of United States Army Major General Philip H. Sheridan of Fort Sill, the Indian Territory of these United States of America. The fugitives Mudlark Abercromby MacGyver alias "Muddy," alias "Mudshoe," alias "Pensicola Thelma," and one Major Richard Carter, alias "Gentleman Rick," alias "Poor Richard," alias "Gumball Ricky," both formerly of the Confederate States Army, having been implicated by observation and circumstance of innumerable delicta, dacoiteries, iniquities, infringements, infractions, and indeed immorality, as well as trangressions, trespassing and trainstopping, are considered deleterious and detrimental to the welfare of the State, and THEREFORE, ordered thereupon that a Mittimus be made out to keep them confined until such time as they be discharged for proper hanging -- It's signed by the General."

"Mittimus?"

"I reckon it's after Thanksgiving, before Easter." 

Muddy gives you that familiar old look that always leads to trouble. "I got me another cunning plan. C'mon, ask your old buddy Muddy..." Muddy leans forward, clearly impatient for you to ask him about his latest stroke of (in his opinion) genius."

>ask muddy about plan
Muddy says excitedly, "Here's my idea: I reckon I could take that warrant and forge a different ending. Maybe trick them into releasing us."

"That's a great idea, Muddy, let me get my pen and some ink. Oh, wait a minute. I don't have either!" You glare at Muddy.

"Oh, yeah. I suppose. I didn't think of that." Muddy considers the matter. "Maybe we could make one. If you can find something that I can use as a pen, I reckon that one of them red berries would make a right proper kind of ink for it."

>give feather to muddy
"Thanks, partner. That'll make a right proper pen."

He continues, "To finish this business with the warrant, I'll need something to serve as ink."

>give berry to muddy
"Thank you kindly. I reckon that will make a right fine ink." Muddy dabs the feather in the berry, soaking up the berry juice. 

He continues, "To finish this business with the warrant, I'll need the warrant itself."

>give warrant to muddy
Muddy accepts the document and stares at it for a while, turning it this way and that.

Muddy applies his quill to the paper and with a few flourishes, scrawls an additional sentence on the warrant. He blows gently on it to dry the "ink" and hands the warrant back to you for your inspection.

>read warrant
It says: FEDERAL WARRANT. This warrant is issued this eleventh day of December in the year of Our Lord Eighteen Hundred and Seventy-One and duly executed by the hand of United States Army Major General Philip H. Sheridan of Fort Sill, the Indian Territory of these United States of America. The fugitives Mudlark Abercromby MacGyver alias "Muddy," alias "Mudshoe," alias "Pensicola Thelma," and one Major Richard Carter, alias "Gentleman Rick," alias "Poor Richard," alias "Gumball Ricky," both formerly of the Confederate States Army, having been implicated by observation and circumstance of innumerable delicta, dacoiteries, iniquities, infringements, infractions, and indeed immorality, as well as trangressions, trespassing and trainstopping, are considered deleterious and detrimental to the welfare of the State, and THEREFORE, ordered thereupon that a Mittimus be made out to keep them confined until such time as they be discharged for proper hanging of the Sheriff's portrait on the office wall.

>show warrant to deputy
The deputy looks like he has better things to do, but looks over at the warrant and says, "A very complicated legal document the likes of which ain't nobody really understand."

>e
As you leave to go, the harmonica is yanked away from you by the wall-chain.

You can't, since the gate is in the way.

>tree
compass (6) 
  the north
  the northeast
  the northwest
  the south
  the southeast
  the southwest
  the east
  the west
  the up
  the down
  the inside
  the outside
(darkness object) (7) 
(Inform Parser) (8) 
(Inform Library) (9) 
(property_numberspace_forcer) (10) 
(ValuePropertyHolder) (32) 
Library message debug (45) 
I7_LibraryMessages (46) 
jail cell (47) 
  a harmonica
  a saloon
  a corn
  a deer
  some fields
  a range
  an outdoors
  some vultures
  a sky
  some walls
  a ceiling
  yourself
    a warrant
    a small brass key
    your right boot (being worn)
    your left boot (being worn)
    a gray bar (empty)
    a spur
    your pocketwatch
    your hat (being worn, and open but empty)
    your pants (being worn)
    a scrap of paper
    your overcoat (being worn)
  a can of beans (open)
    a spoon
  a footwear
  a cell window
  a gate
  a floor
  a stool
  a bench
  some bars
  Muddy
    a feather
    a frock coat (being worn)
    suit (being worn)
  Pete
your former self (48) 
office (65) 
  a deputy
    a cigar
    a bottle of whiskey
  some swinging doors
  a boiler
  a cabinet (closed)
    a banana
    a gun belt
  a chair
  a desk
  a portrait
  a machine
Limbo (77) 
  a lever
  Flash
  a cup
    a cup of coffee
  a screw
  a stain
  some army guards
  a marshal
  a sheriff
gap (85) 
jailhouse (92) 
hook (97) 
  a bell
grate (99) 
ball (100) 
top of the cabinet (102) 
cabinet door (104) 
holster (105) 
  your gun
drawer (107) 
  a folder (closed)
    a telegram
    a patent
    a note
    a receipt
metal lock (113) 
paper (114) 
antelope (119) 
iron pipe (121) 
nozzle (122) 
chute (123) 
whiskey bottle (124) 
jail door (125) 
gate lock (128) 
bronze plate (129) 
seat (130) 
initials (131) 
socket (132) 
harmonica-textbox (133) 
chain (134) 
street (137) 
  a barrel
    a hunk of meat
    a vulture
  a vine
rods (141) 
berry (142) 
collar (144) 
colar (145) 
leash (146) 
pocket (147) 
  a pamphlet
  a tin (closed)
    a wad of tobacco
mouth (151) 
your mouth (152) 
mount (155) 
tail (156)

>x desk
A beat-up old wooden desk with time-worn corners, and a pitted, scratched surfacee. The rear of the desk has a small drawer.

>open drawer
You can't get over to the office from here.

>search deputy
The deputy groans deeply and curls up into a ball, rolling towards you and blinking quickly. His half-focused eyes drift from you to Pastor Pete and finally fix on Muddy who gives him a full-toothed (as many as Muddy still has, at any rate) grin.

The disoriented deputy asks, "What? What in tarnation happened?"

Muddy takes the initiative, "I reckon you must've drunk some potent firewater, deputy. You plumb passed out. Now, why don't you get up and let us out, we got work to do -- just like it says on that federal warrant."

The dull-witted deputy, still stunned by the recent turn of events stares at the warrant.

Muddy leans forward and points out, "Down there, near the bottom. It says that we should be discharged to hang up the sheriff's portrait, don't it?"

The deputy yawns and rubs his eyes, "I reckon it do. But I thought you was criminals."

"Oh shucks, no, deputy." Muddy puts on his most endearing smile. "Don't you remember the sheriff asking you to take care of his guests? We were just staying here overnight. Now, why don't you let us out? The sheriff's going to be mad at us all if that picture ain't hung by morning."

The deputy reaches down and does something arcane to the lock. You don't quite see what he did, but it clicks open. He slumps wearily against the jail bars and the gate swings open, permitting passage eastward into the office.

>open drawer with key
You'd have to go over to the office first.

>open drawer
You'd have to go over to the office first.

>open folder
You ain't able to see no such thing.

>read telegram
You ain't able to see no such thing.

>x patent
You ain't able to see no such thing.

>x note
You ain't able to see no such thing.

>x receipt
You ain't able to see no such thing.

>take all
You can't use multiple objects with that verb.

>take telegram, patent, receipt
You ain't able to see no such thing.

>take telegram
You ain't able to see no such thing.

>take patent
You ain't able to see no such thing.

>take receipt
You ain't able to see no such thing.

>x cabinet
Which all do you mean, the cabinet, the top of the cabinet, or the cabinet door?

>open cabinet
(the cabinet)
You'd have to go over to the office first.

>take gun belt
You ain't able to see no such thing.

>take gun
You ain't able to see no such thing.

>x gun
You ain't able to see no such thing.

>x muddy
Muddy is well... muddy. His dated tweed three-piece suit is tattered, and doesn't at all match his formal frock coat, which is covered with dust and mud. In short, he hasn't changed a jot since the day you were both picked up for desertion and thrown in the stockade.

>l
Jail Cell
The small jail cell is brick on three sides, metal bars on the other, with an unlocked gate. A small window is set into the brickwork above your head. Through the jail bars you can see the sheriff's office.

A repaired stool stands upright.

Muddy leans against the wall.

In the corner of the cell, a disheveled man in a black suit is stretched out on a crude wooden bench and is snoring loudly, oblivious to your presence.

You can also see a harmonica and a can of beans (in which is a spoon) here.

In the office you can see a deputy.

>hang picture
What do you want to hang the portrait on?

>hang portrait on wall
You'd have to go over to the office first.

>e
[Your score has just gone up by five]

Office
A one room jailhouse is fitting for this jerkwater town. There's a big, wooden desk in the middle of the room, and behind it sits the deputy. Just behind the desk is a fancy cabinet, with real glass in the door. Next to the cabinet, a large, framed picture of the sheriff stands on the floor. To the side of the desk, there is a weird looking contraption: clearly, some sort of steam boiler which is connected by pipes to a strange looking machine. On the opposite side of the room, two swinging doors lead back to town. Flash's empty dog food bowl is nailed to the floor just in front of your jail cell.

Muddy leans against the wall.

You can also see a deputy here.

A repaired stool stands upright.

In the corner of the cell, a disheveled man in a black suit is stretched out on a crude wooden bench and is snoring loudly, oblivious to your presence.

In the jail cell you can also see a harmonica and a can of beans (in which is a spoon).

>wake deputy
The deputy groans deeply and curls up into a ball. You keep poking him with your finger, and finally he rolls towards you, blinking quickly. His half-focused eyes drift from you to Pastor Pete and finally fix on Muddy who gives him a full-toothed (as many as Muddy still has, at any rate) grin.

The disoriented deputy asks, "What? What in tarnation happened?"

Muddy takes the initiative, "I reckon you must've drunk some potent firewater, deputy. You plumb passed out. Now, why don't you get up and let us out, we got work to do -- just like it says on that federal warrant."

The dull-witted deputy, still stunned by the recent turn of events stares at the warrant.

Muddy leans forward and points out, "Down there, near the bottom. It says that we should be discharged to hang up the sheriff's portrait, don't it?"

The deputy yawns and rubs his eyes, "I reckon it do. But I thought you was criminals."

"Oh shucks, no, deputy." Muddy puts on his most endearing smile. "Don't you remember the sheriff asking you to take care of his guests? We were just staying here overnight. Now, why don't you let us out? The sheriff's going to be mad at us all if that picture ain't hung by morning."

The deputy reaches down and does something arcane to the lock. You don't quite see what he did, but it clicks open. He slumps wearily against the jail bars and the gate swings open, permitting passage eastward into the office.

>show patent to marshal
You ain't able to see no such thing.

>show telegram to marshal
You ain't able to see no such thing.

>show receipt
You ain't able to see no such thing.

>show receipt to marshal
You ain't able to see no such thing.

* * *

>x receipt
You ain't able to see no such thing.

>e
[Your score has just gone up by five]

Office
A one room jailhouse is fitting for this jerkwater town. There's a big, wooden desk in the middle of the room, and behind it sits the deputy. Just behind the desk is a fancy cabinet, with real glass in the door. Next to the cabinet, a large, framed picture of the sheriff stands on the floor. To the side of the desk, there is a weird looking contraption: clearly, some sort of steam boiler which is connected by pipes to a strange looking machine. On the opposite side of the room, two swinging doors lead back to town. Flash's empty dog food bowl is nailed to the floor just in front of your jail cell.

Muddy leans against the wall.

You can also see a deputy here.

A repaired stool stands upright.

In the corner of the cell, a disheveled man in a black suit is stretched out on a crude wooden bench and is snoring loudly, oblivious to your presence.

In the jail cell you can also see a harmonica and a can of beans (in which is a spoon).

>search desk
There ain't nothing on the desk.

>open drawer with brass key
You unlock the drawer.

>g
You slide the drawer open revealing a folder.
[Your score has just gone up by one]

>wait
Time passes.

>g
Time passes.

>get folder
Fetched.

>open folder
You open the folder, revealing a telegram, a patent, a note, and a receipt.

>e
Muddy relents and says, "All right, Rick. I reckon we done what we can done. Let's make for the hills."

As you head out of the office, two men appear in the door way: Sheriff Cheney and Federal Marshal McLuhan. They are followed by a small detachment of U.S. Army guards.

Sheriff Cheney surges forward pointing his finger at you and Muddy, "It were these two what blown up that train tunnel! They's escaping when we walked in! Look, they done killed my deputy! We should drop 'em where they stand."

The marshal looks uncertain and waves the army guards forward, training their pistols on you. 

He rests his hand on the sheriff's trigger arm and says, "Sheriff, without any evidence to substantiate your accusation regarding the train robbery, I was reluctant to see these men hanged without a trial. Given the corpse of a lawman in front of us, though, even I have to agree that justice should be swift and definitive in this instance."

>wait
Time passes.

Muddy whispers, "Rick, we ain't got long. I reckon that marshal is someone what can be reasoned with."

>g
Time passes.

The marshal advises, "Citizens, I am required by federal law as it applies to the Territory to advise you that CAPITAL CHARGES have been filed against you, and summary execution will take place, unless evidence to the contrary can be brought to light."

The sheriff rolls his eyes, "For the sake of the all that's Holy, whyn't we shoot 'em dead right here?"

The marshal looks at Sheriff Cheney and answers, "Because some of us believe in maintaining some semblance of due process."

>show telegram to sheriff
(first taking the telegram)
The marshal demands, "As the senior law man present, all evidence must be presented to me."

Muddy whispers, "We got to show that marshal something. I reckon maybe we could make up some kind of excuse or shift the blame, maybe."

>show telegram to marshal
You show the telegram to Marshal McLuhan, telling him that he'll find the sheriff's stage coach full of stolen silver just behind the jail.

Sheriff Cheney wipes his brow nervously, "I forgot that's where we left that coach. I do reckon I'm always forgetting where I park. I was going to mention the silver as evidence any second now."

The marshal strokes his chin. "You're saying that the sheriff intended to abscond with these funds instead of turning them to state's evidence? Can you show me any additional evidence that would corroborate this grave accusation? I'm not inclined to distrust an officer of the law. It is true that the sheriff had some personal business concerns, but I have seen nothing to make me suspect that he was lacking for funds."

Sheriff Cheney walks behind the office desk and is alarmed to see that the drawer has been unlocked.

>show receipt to marshal
(first taking the receipt)
You show the marshal the receipt and suggest that the sheriff is quite in debt, and might turn to illegal activities to pay it off. 

The marshal looks disappointed and says, "Being in debt is no crime, although it does eat away at the soul. Once, I went an entire week owing more then five dollars, and I regret it to this day. However, there is nothing to suggest that the sheriff had any sort of plan that would have required this much money."

Muddy whispers, "Rick, we're almost out of time. You got to convince that marshal that we ain't no more crooked than that sheriff."

>i
You're carrying a receipt, a telegram, a folder, a warrant, a small brass key, a gray bar, a spur, your pocketwatch, and a scrap of paper. You are wearing your right boot, left boot, hat, pants, and overcoat. 

Your revolver was confiscated, it seems.

An excited looking army guard burst into the room and tells the marshal, "We just found a whole wagon of silver around the back of the jail. Looks like it was stolen from that train."

The sheriff winces, but remains quiet.

>look in folder
In the folder are a patent and a note.

The marshal advises the sheriff that he will need the federal warrant to take you and Muddy to the Fort for hanging.

>show patent to marshal
(first taking the patent)
You show the patent to marshal, and intimate that the sheriff had extensive business plans, far beyond his his mandate as a public servant. 

Marshal McLuhan instructs his guards to restrain and disarm the sheriff, concluding, "So, now it is clear. The sheriff took advantage of the railway incident to rob the train's silver himself in order to finance the development of his invention into a business. He framed these two itinerant laborers to shift the blame. No wonder he wanted them killed so quickly."

The marshal rips the gold star off the Sheriff Cheney's shirt and instructs the guards, "Place Mr. Cheney behind bars."

Pastor Pete yawns and walks out of the cell as the guards wrestle the sheriff past him. "I do reckon I slept like the dead last night. Thank you for a peaceful night, deputy," and he walks out the front door.

The marshal raises his eyebrows, but continues, "Deputy James Smith Bush, by the power invested in me as federal marshal of this district, I hereby promote you to Sheriff of the Town of Crawdad's Gulch. Congratulations." The newly appointed sheriff grins and shakes his hand. As the marshal pins the star on Jimbo's chest he advises, "James, you'll probably want to get yourself some deputies -- men you can trust."

Sheriff Jim looks over to you and Muddy. The color drains from Muddy's face.
[Your score has just gone up by five]

The sheriff searches the office in vain for the federal warrant for your arrest, and not finding it, sends a guard to fetch a copy from the telegraph office. He continues to search, though, as if looking for some other papers.

*** YOU WIN ***

Would you like to RESTART, RESTORE a saved game, see some suggestions for AMUSING things to do, or QUIT?

>udo
Enough of your blatheration. Give one of them answers from above.

Would you like to RESTART, RESTORE a saved game, see some suggestions for AMUSING things to do, or QUIT?

>undo
office
You done backtracked some.

>wait
Time passes.

The sheriff searches the office in vain for the federal warrant for your arrest, and not finding it, sends a guard to fetch a copy from the telegraph office. He continues to search, though, as if looking for some other papers.

>g
Time passes.

The sheriff looks nervously around the office.

>g
Time passes.

The sheriff looks in his cabinet and behind the portrait.

>g
Time passes.

The sheriff looks through everything in the jail cell, still searching.

>g
Time passes.

An army guard enters the office and hands a yellow telegram form to the federal marshal.

>g
Time passes.

The marshal telegram, shaking his head sadly.

>g
Time passes.

The marshal commands his men to take you into custody and escort you out to the waiting coach.

>g
Time passes.

Several hours later, from your high platform, you and Muddy have an excellent view of the area around Fort Sill.

Muddy turns to you, "Well, reckon we'll be seeing each other real soon now. It was an honor and a pleasure, sir."There is a creaking sound followed by a falling sensation.

*** HANGED ***

Would you like to RESTART, RESTORE a saved game, or QUIT?

* * *

>hint
Some players may find the temptation to rely on hints overwhelming, and you may prefer to remove temptation by disabling hints for the rest of this game. If you do so, however, you will not be able to access the hints unless you restart. Do you wish to disable hints? >

>n
Okay - but if you change your mind later you can use the HINTS OFF command to disable hints.

 > Finding stuff in the jail cell
   The deputy's out cold. Now what?

>
   Finding stuff in the jail cell
 > The deputy's out cold. Now what?
   Finding stuff in the jail cell
 > The deputy's out cold. Now what?

1/4: Now that the big oaf has clapsed next the jail cell, you can reach him.

Press SPACE to return to the menu or H to reveal another hint.

>h
1/4: Now that the big oaf has clapsed next the jail cell, you can reach him.

2/4: He's even less talkative that usual in this state, so witty repartée is probably not going to get you very far.

Press SPACE to return to the menu or H to reveal another hint.

>h
1/4: Now that the big oaf has clapsed next the jail cell, you can reach him.

2/4: He's even less talkative that usual in this state, so witty repartée is probably not going to get you very far.

3/4: Does the deputy have anything that might be of use to you?

Press SPACE to return to the menu or H to reveal another hint.

>h
1/4: Now that the big oaf has clapsed next the jail cell, you can reach him.

2/4: He's even less talkative that usual in this state, so witty repartée is probably not going to get you very far.

3/4: Does the deputy have anything that might be of use to you?

4/4: You can SEARCH people to see what they are carrying. The deputy is too sedated to take exception to your searching.

Press SPACE to return to the menu.

   Finding stuff in the jail cell
 > The deputy's out cold. Now what?
   Finding stuff in the jail cell
 > The deputy's out cold. Now what?

>q
Jail Cell (on the stool)
The small jail cell is brick on three sides, metal bars on the other, with a tightly locked gate. A small window is set into the brickwork above your head. Through the jail bars you can see the sheriff's office.

Muddy leans against the wall.

In the corner of the cell, a disheveled man in a black suit is stretched out on a crude wooden bench and is snoring loudly, oblivious to your presence.

You can also see a can of beans (in which is a spoon) and a hunk of meat here.

* * *

>blow berry at coffee
The berry splatters against the side of the cup, and its juice drips into the steaming brew.

Muddy jumps up, claps you congratulatorily on the back, and you nearly swallow the metal tube still held to your lips.

He beams, "That were a one in a million shot, Rick!"  Muddy strokes his chin and wags a finger at the coffee, "Now, if we can only get the deputy to come back and drink that coffee, he might be a whole lot more cooperative, I reckon."

You sure like the way Muddy thinks.
[Your score has just gone up by one]

>hint
Some players may find the temptation to rely on hints overwhelming, and you may prefer to remove temptation by disabling hints for the rest of this game. If you do so, however, you will not be able to access the hints unless you restart. Do you wish to disable hints? >

>no
Okay - but if you change your mind later you can use the HINTS OFF command to disable hints.

 > Finding stuff in the jail cell
   Getting the deputy to drink the coffee

>q
Jail Cell (on the stool)
The small jail cell is brick on three sides, metal bars on the other, with a tightly locked gate. A small window is set into the brickwork above your head. Through the jail bars you can see the sheriff's office.

Muddy leans against the wall.

In the corner of the cell, a disheveled man in a black suit is stretched out on a crude wooden bench and is snoring loudly, oblivious to your presence.

You can also see a can of beans (in which is a spoon) and a hunk of meat here.

>showme coffee
coffee - thing
location: in the cup on the machine in the office
unlit; inedible; portable; plural-named; improper-named; neuter; ordinarily enumerated
description: Steaming hot, black Joe.
printed name: coffee
indefinite article: a cup of
texture: steaming hot
scent: tantalizing
inscription: 
spiked

>wait
Time passes.

>hint
 > Finding stuff in the jail cell
   Getting the deputy to drink the coffee

>q
Jail Cell (on the stool)
The small jail cell is brick on three sides, metal bars on the other, with a tightly locked gate. A small window is set into the brickwork above your head. Through the jail bars you can see the sheriff's office.

Muddy leans against the wall.

In the corner of the cell, a disheveled man in a black suit is stretched out on a crude wooden bench and is snoring loudly, oblivious to your presence.

You can also see a can of beans (in which is a spoon) and a hunk of meat here.

>hint
 > Finding stuff in the jail cell
   Getting the deputy to drink the coffee

>
   Finding stuff in the jail cell
 > Getting the deputy to drink the coffee
   Finding stuff in the jail cell
 > Getting the deputy to drink the coffee

1/11: How clever. You've doped the deputy's coffee, so if he drinks some, it will put him to sleep instead of waking him up. Now the question is -- how to you get him back to the jail house?

Press SPACE to return to the menu or H to reveal another hint.

>h
1/11: How clever. You've doped the deputy's coffee, so if he drinks some, it will put him to sleep instead of waking him up. Now the question is -- how to you get him back to the jail house?

2/11: The deputy said he'd know if you were making a break for it.

Press SPACE to return to the menu or H to reveal another hint.

>h
1/11: How clever. You've doped the deputy's coffee, so if he drinks some, it will put him to sleep instead of waking him up. Now the question is -- how to you get him back to the jail house?

2/11: The deputy said he'd know if you were making a break for it.

3/11: Before the deputy left, he did something with Flash.

Press SPACE to return to the menu or H to reveal another hint.

>h
1/11: How clever. You've doped the deputy's coffee, so if he drinks some, it will put him to sleep instead of waking him up. Now the question is -- how to you get him back to the jail house?

2/11: The deputy said he'd know if you were making a break for it.

3/11: Before the deputy left, he did something with Flash.

4/11: To make the coffee, you had to attract Flash towards the jail cell or his food bowl. His leash then pulled the lever in that direction, turning on the coffee machine.

Press SPACE to return to the menu or H to reveal another hint.

>h
1/11: How clever. You've doped the deputy's coffee, so if he drinks some, it will put him to sleep instead of waking him up. Now the question is -- how to you get him back to the jail house?

2/11: The deputy said he'd know if you were making a break for it.

3/11: Before the deputy left, he did something with Flash.

4/11: To make the coffee, you had to attract Flash towards the jail cell or his food bowl. His leash then pulled the lever in that direction, turning on the coffee machine.

5/11: He tied Flash to the lever so that if you went towards the door and old Flash gave chase (for a few feet), Flash would set off the train whistle as an alarm.

Press SPACE to return to the menu or H to reveal another hint.

>h
1/11: How clever. You've doped the deputy's coffee, so if he drinks some, it will put him to sleep instead of waking him up. Now the question is -- how to you get him back to the jail house?

2/11: The deputy said he'd know if you were making a break for it.

3/11: Before the deputy left, he did something with Flash.

4/11: To make the coffee, you had to attract Flash towards the jail cell or his food bowl. His leash then pulled the lever in that direction, turning on the coffee machine.

5/11: He tied Flash to the lever so that if you went towards the door and old Flash gave chase (for a few feet), Flash would set off the train whistle as an alarm.

6/11: What happens if Flash goes in the other direction -- away from the jail cell and towards the door that leads to the street?

Press SPACE to return to the menu or H to reveal another hint.

>h
1/11: How clever. You've doped the deputy's coffee, so if he drinks some, it will put him to sleep instead of waking him up. Now the question is -- how to you get him back to the jail house?

2/11: The deputy said he'd know if you were making a break for it.

3/11: Before the deputy left, he did something with Flash.

4/11: To make the coffee, you had to attract Flash towards the jail cell or his food bowl. His leash then pulled the lever in that direction, turning on the coffee machine.

5/11: He tied Flash to the lever so that if you went towards the door and old Flash gave chase (for a few feet), Flash would set off the train whistle as an alarm.

6/11: What happens if Flash goes in the other direction -- away from the jail cell and towards the door that leads to the street?

7/11: Flash, being a bloodhound of unquestionable lineage, has a fine sense of smell.

Press SPACE to return to the menu or H to reveal another hint.

>h
1/11: How clever. You've doped the deputy's coffee, so if he drinks some, it will put him to sleep instead of waking him up. Now the question is -- how to you get him back to the jail house?

2/11: The deputy said he'd know if you were making a break for it.

3/11: Before the deputy left, he did something with Flash.

4/11: To make the coffee, you had to attract Flash towards the jail cell or his food bowl. His leash then pulled the lever in that direction, turning on the coffee machine.

5/11: He tied Flash to the lever so that if you went towards the door and old Flash gave chase (for a few feet), Flash would set off the train whistle as an alarm.

6/11: What happens if Flash goes in the other direction -- away from the jail cell and towards the door that leads to the street?

7/11: Flash, being a bloodhound of unquestionable lineage, has a fine sense of smell.

8/11: To get Flash to back away from the jail cell, you need to create a stink.

Press SPACE to return to the menu or H to reveal another hint.

* * *

>h
1/11: How clever. You've doped the deputy's coffee, so if he drinks some, it will put him to sleep instead of waking him up. Now the question is -- how to you get him back to the jail house?

2/11: The deputy said he'd know if you were making a break for it.

3/11: Before the deputy left, he did something with Flash.

4/11: To make the coffee, you had to attract Flash towards the jail cell or his food bowl. His leash then pulled the lever in that direction, turning on the coffee machine.

5/11: He tied Flash to the lever so that if you went towards the door and old Flash gave chase (for a few feet), Flash would set off the train whistle as an alarm.

6/11: What happens if Flash goes in the other direction -- away from the jail cell and towards the door that leads to the street?

7/11: Flash, being a bloodhound of unquestionable lineage, has a fine sense of smell.

8/11: To get Flash to back away from the jail cell, you need to create a stink.

9/11: There are a couple ways to make a bad smell. You've already used up your beans, so you'll have to find another way.

Press SPACE to return to the menu or H to reveal another hint.

* * *

>h
1/11: How clever. You've doped the deputy's coffee, so if he drinks some, it will put him to sleep instead of waking him up. Now the question is -- how to you get him back to the jail house?

2/11: The deputy said he'd know if you were making a break for it.

3/11: Before the deputy left, he did something with Flash.

4/11: To make the coffee, you had to attract Flash towards the jail cell or his food bowl. His leash then pulled the lever in that direction, turning on the coffee machine.

5/11: He tied Flash to the lever so that if you went towards the door and old Flash gave chase (for a few feet), Flash would set off the train whistle as an alarm.

6/11: What happens if Flash goes in the other direction -- away from the jail cell and towards the door that leads to the street?

7/11: Flash, being a bloodhound of unquestionable lineage, has a fine sense of smell.

8/11: To get Flash to back away from the jail cell, you need to create a stink.

9/11: There are a couple ways to make a bad smell. You've already used up your beans, so you'll have to find another way.

10/11: Taking off your boots is sure make Flash want to give you some distance.

Press SPACE to return to the menu or H to reveal another hint.

>h
1/11: How clever. You've doped the deputy's coffee, so if he drinks some, it will put him to sleep instead of waking him up. Now the question is -- how to you get him back to the jail house?

2/11: The deputy said he'd know if you were making a break for it.

3/11: Before the deputy left, he did something with Flash.

4/11: To make the coffee, you had to attract Flash towards the jail cell or his food bowl. His leash then pulled the lever in that direction, turning on the coffee machine.

5/11: He tied Flash to the lever so that if you went towards the door and old Flash gave chase (for a few feet), Flash would set off the train whistle as an alarm.

6/11: What happens if Flash goes in the other direction -- away from the jail cell and towards the door that leads to the street?

7/11: Flash, being a bloodhound of unquestionable lineage, has a fine sense of smell.

8/11: To get Flash to back away from the jail cell, you need to create a stink.

9/11: There are a couple ways to make a bad smell. You've already used up your beans, so you'll have to find another way.

10/11: Taking off your boots is sure make Flash want to give you some distance.

11/11: One boot may not be enough.

Press SPACE to return to the menu.

   Finding stuff in the jail cell
 > Getting the deputy to drink the coffee
   Finding stuff in the jail cell
 > Getting the deputy to drink the coffee

* * *

>take berry
You pluck a plump juicy red berry from the part of the vine growing outside the window.
[Your score has just gone up by one]

>hint
Some players may find the temptation to rely on hints overwhelming, and you may prefer to remove temptation by disabling hints for the rest of this game. If you do so, however, you will not be able to access the hints unless you restart. Do you wish to disable hints? >

>n
Okay - but if you change your mind later you can use the HINTS OFF command to disable hints.

 > Finding stuff in the jail cell
   What's this berry good for?

>
   Finding stuff in the jail cell
 > What's this berry good for?
   Finding stuff in the jail cell
 > What's this berry good for?

1/14: So, you have a juicy little red berry, do you? Have you asked Muddy's opinion? Maybe if he takes a look at the berry, he can give you some advice.

Press SPACE to return to the menu or H to reveal another hint.

>h
1/14: So, you have a juicy little red berry, do you? Have you asked Muddy's opinion? Maybe if he takes a look at the berry, he can give you some advice.

2/14: You could, at your own risk, see what happens if you eat one of those berries. Eating random berries may not be the best idea.

Press SPACE to return to the menu or H to reveal another hint.

>h
1/14: So, you have a juicy little red berry, do you? Have you asked Muddy's opinion? Maybe if he takes a look at the berry, he can give you some advice.

2/14: You could, at your own risk, see what happens if you eat one of those berries. Eating random berries may not be the best idea.

3/14: Did you SHOW the berry to Muddy? If so, does its name suggest any uses for the berry?

Press SPACE to return to the menu or H to reveal another hint.

>h
1/14: So, you have a juicy little red berry, do you? Have you asked Muddy's opinion? Maybe if he takes a look at the berry, he can give you some advice.

2/14: You could, at your own risk, see what happens if you eat one of those berries. Eating random berries may not be the best idea.

3/14: Did you SHOW the berry to Muddy? If so, does its name suggest any uses for the berry?

4/14: You can use the snooze berry to drug the deputy.

Press SPACE to return to the menu or H to reveal another hint.

>h
1/14: So, you have a juicy little red berry, do you? Have you asked Muddy's opinion? Maybe if he takes a look at the berry, he can give you some advice.

2/14: You could, at your own risk, see what happens if you eat one of those berries. Eating random berries may not be the best idea.

3/14: Did you SHOW the berry to Muddy? If so, does its name suggest any uses for the berry?

4/14: You can use the snooze berry to drug the deputy.

5/14: You'll have to find a way of getting the deputy to ingest the berry. He's not the most cooperative guy, so you'll have to be clever.

Press SPACE to return to the menu or H to reveal another hint.

>h
1/14: So, you have a juicy little red berry, do you? Have you asked Muddy's opinion? Maybe if he takes a look at the berry, he can give you some advice.

2/14: You could, at your own risk, see what happens if you eat one of those berries. Eating random berries may not be the best idea.

3/14: Did you SHOW the berry to Muddy? If so, does its name suggest any uses for the berry?

4/14: You can use the snooze berry to drug the deputy.

5/14: You'll have to find a way of getting the deputy to ingest the berry. He's not the most cooperative guy, so you'll have to be clever.

6/14: There probably isn't any good way to convince the deputy to eat the berry. You can try, but he isn't much on conversation.

Press SPACE to return to the menu or H to reveal another hint.

>h
1/14: So, you have a juicy little red berry, do you? Have you asked Muddy's opinion? Maybe if he takes a look at the berry, he can give you some advice.

2/14: You could, at your own risk, see what happens if you eat one of those berries. Eating random berries may not be the best idea.

3/14: Did you SHOW the berry to Muddy? If so, does its name suggest any uses for the berry?

4/14: You can use the snooze berry to drug the deputy.

5/14: You'll have to find a way of getting the deputy to ingest the berry. He's not the most cooperative guy, so you'll have to be clever.

6/14: There probably isn't any good way to convince the deputy to eat the berry. You can try, but he isn't much on conversation.

7/14: He does like coffee, though.

Press SPACE to return to the menu or H to reveal another hint.

>h
1/14: So, you have a juicy little red berry, do you? Have you asked Muddy's opinion? Maybe if he takes a look at the berry, he can give you some advice.

2/14: You could, at your own risk, see what happens if you eat one of those berries. Eating random berries may not be the best idea.

3/14: Did you SHOW the berry to Muddy? If so, does its name suggest any uses for the berry?

4/14: You can use the snooze berry to drug the deputy.

5/14: You'll have to find a way of getting the deputy to ingest the berry. He's not the most cooperative guy, so you'll have to be clever.

6/14: There probably isn't any good way to convince the deputy to eat the berry. You can try, but he isn't much on conversation.

7/14: He does like coffee, though.

8/14: Is there any way to get the berry into the coffee?

Press SPACE to return to the menu or H to reveal another hint.

>h
1/14: So, you have a juicy little red berry, do you? Have you asked Muddy's opinion? Maybe if he takes a look at the berry, he can give you some advice.

2/14: You could, at your own risk, see what happens if you eat one of those berries. Eating random berries may not be the best idea.

3/14: Did you SHOW the berry to Muddy? If so, does its name suggest any uses for the berry?

4/14: You can use the snooze berry to drug the deputy.

5/14: You'll have to find a way of getting the deputy to ingest the berry. He's not the most cooperative guy, so you'll have to be clever.

6/14: There probably isn't any good way to convince the deputy to eat the berry. You can try, but he isn't much on conversation.

7/14: He does like coffee, though.

8/14: Is there any way to get the berry into the coffee?

9/14: It's a tough shot to get the berry into the coffee cup. You'll need some kind of way of aiming the berry.

Press SPACE to return to the menu or H to reveal another hint.

>h
1/14: So, you have a juicy little red berry, do you? Have you asked Muddy's opinion? Maybe if he takes a look at the berry, he can give you some advice.

2/14: You could, at your own risk, see what happens if you eat one of those berries. Eating random berries may not be the best idea.

3/14: Did you SHOW the berry to Muddy? If so, does its name suggest any uses for the berry?

4/14: You can use the snooze berry to drug the deputy.

5/14: You'll have to find a way of getting the deputy to ingest the berry. He's not the most cooperative guy, so you'll have to be clever.

6/14: There probably isn't any good way to convince the deputy to eat the berry. You can try, but he isn't much on conversation.

7/14: He does like coffee, though.

8/14: Is there any way to get the berry into the coffee?

9/14: It's a tough shot to get the berry into the coffee cup. You'll need some kind of way of aiming the berry.

10/14: Does the gray bar have any special qualities? Maybe something that might explain why it vibrated differently that the other bars?

Press SPACE to return to the menu or H to reveal another hint.

>h
1/14: So, you have a juicy little red berry, do you? Have you asked Muddy's opinion? Maybe if he takes a look at the berry, he can give you some advice.

2/14: You could, at your own risk, see what happens if you eat one of those berries. Eating random berries may not be the best idea.

3/14: Did you SHOW the berry to Muddy? If so, does its name suggest any uses for the berry?

4/14: You can use the snooze berry to drug the deputy.

5/14: You'll have to find a way of getting the deputy to ingest the berry. He's not the most cooperative guy, so you'll have to be clever.

6/14: There probably isn't any good way to convince the deputy to eat the berry. You can try, but he isn't much on conversation.

7/14: He does like coffee, though.

8/14: Is there any way to get the berry into the coffee?

9/14: It's a tough shot to get the berry into the coffee cup. You'll need some kind of way of aiming the berry.

10/14: Does the gray bar have any special qualities? Maybe something that might explain why it vibrated differently that the other bars?

11/14: The gray bar is hollow.

Press SPACE to return to the menu or H to reveal another hint.

>h
1/14: So, you have a juicy little red berry, do you? Have you asked Muddy's opinion? Maybe if he takes a look at the berry, he can give you some advice.

2/14: You could, at your own risk, see what happens if you eat one of those berries. Eating random berries may not be the best idea.

3/14: Did you SHOW the berry to Muddy? If so, does its name suggest any uses for the berry?

4/14: You can use the snooze berry to drug the deputy.

5/14: You'll have to find a way of getting the deputy to ingest the berry. He's not the most cooperative guy, so you'll have to be clever.

6/14: There probably isn't any good way to convince the deputy to eat the berry. You can try, but he isn't much on conversation.

7/14: He does like coffee, though.

8/14: Is there any way to get the berry into the coffee?

9/14: It's a tough shot to get the berry into the coffee cup. You'll need some kind of way of aiming the berry.

10/14: Does the gray bar have any special qualities? Maybe something that might explain why it vibrated differently that the other bars?

11/14: The gray bar is hollow.

12/14: Have you tried putting things in the gray bar?

Press SPACE to return to the menu or H to reveal another hint.

>h
1/14: So, you have a juicy little red berry, do you? Have you asked Muddy's opinion? Maybe if he takes a look at the berry, he can give you some advice.

2/14: You could, at your own risk, see what happens if you eat one of those berries. Eating random berries may not be the best idea.

3/14: Did you SHOW the berry to Muddy? If so, does its name suggest any uses for the berry?

4/14: You can use the snooze berry to drug the deputy.

5/14: You'll have to find a way of getting the deputy to ingest the berry. He's not the most cooperative guy, so you'll have to be clever.

6/14: There probably isn't any good way to convince the deputy to eat the berry. You can try, but he isn't much on conversation.

7/14: He does like coffee, though.

8/14: Is there any way to get the berry into the coffee?

9/14: It's a tough shot to get the berry into the coffee cup. You'll need some kind of way of aiming the berry.

10/14: Does the gray bar have any special qualities? Maybe something that might explain why it vibrated differently that the other bars?

11/14: The gray bar is hollow.

12/14: Have you tried putting things in the gray bar?

13/14: You can use the gray bar as a blow gun. It's very accurate.

Press SPACE to return to the menu or H to reveal another hint.

>h
1/14: So, you have a juicy little red berry, do you? Have you asked Muddy's opinion? Maybe if he takes a look at the berry, he can give you some advice.

2/14: You could, at your own risk, see what happens if you eat one of those berries. Eating random berries may not be the best idea.

3/14: Did you SHOW the berry to Muddy? If so, does its name suggest any uses for the berry?

4/14: You can use the snooze berry to drug the deputy.

5/14: You'll have to find a way of getting the deputy to ingest the berry. He's not the most cooperative guy, so you'll have to be clever.

6/14: There probably isn't any good way to convince the deputy to eat the berry. You can try, but he isn't much on conversation.

7/14: He does like coffee, though.

8/14: Is there any way to get the berry into the coffee?

9/14: It's a tough shot to get the berry into the coffee cup. You'll need some kind of way of aiming the berry.

10/14: Does the gray bar have any special qualities? Maybe something that might explain why it vibrated differently that the other bars?

11/14: The gray bar is hollow.

12/14: Have you tried putting things in the gray bar?

13/14: You can use the gray bar as a blow gun. It's very accurate.

14/14: You can BLOW the berry ATthe coffee.

Press SPACE to return to the menu.

>h
1/14: So, you have a juicy little red berry, do you? Have you asked Muddy's opinion? Maybe if he takes a look at the berry, he can give you some advice.

2/14: You could, at your own risk, see what happens if you eat one of those berries. Eating random berries may not be the best idea.

3/14: Did you SHOW the berry to Muddy? If so, does its name suggest any uses for the berry?

4/14: You can use the snooze berry to drug the deputy.

5/14: You'll have to find a way of getting the deputy to ingest the berry. He's not the most cooperative guy, so you'll have to be clever.

6/14: There probably isn't any good way to convince the deputy to eat the berry. You can try, but he isn't much on conversation.

7/14: He does like coffee, though.

8/14: Is there any way to get the berry into the coffee?

9/14: It's a tough shot to get the berry into the coffee cup. You'll need some kind of way of aiming the berry.

10/14: Does the gray bar have any special qualities? Maybe something that might explain why it vibrated differently that the other bars?

11/14: The gray bar is hollow.

12/14: Have you tried putting things in the gray bar?

13/14: You can use the gray bar as a blow gun. It's very accurate.

14/14: You can BLOW the berry ATthe coffee.

Press SPACE to return to the menu.

* * *

   Finding stuff in the jail cell
 > What's this berry good for?
   Finding stuff in the jail cell
 > What's this berry good for?

>q
Jail Cell (on the stool)
The small jail cell is brick on three sides, metal bars on the other, with a tightly locked gate. A small window is set into the brickwork above your head. Through the jail bars you can see the sheriff's office.

Muddy leans against the wall.

In the corner of the cell, a disheveled man in a black suit is stretched out on a crude wooden bench and is snoring loudly, oblivious to your presence.

You can also see a can of beans (in which is a spoon) and a hunk of meat here.

* * *

>play harmonica
Again, the room resonates with the rich and vibrant tones of a bagpipe connected to the blowhole of a baluga whale.

Muddy points excitedly towards the top of the gray bar, "When you played, that screw worked its way out more. It's like you got some kind of sonic screwdriver or something! I think one more time will do it."

Flash drools.

>i
You're carrying a harmonica, a spur, your pocketwatch, and a scrap of paper. You are wearing your hat, pants, overcoat, left boot, and right boot. 

Your revolver was confiscated, it seems.

Muddy leans against the wall and sighs.

>hint
Some players may find the temptation to rely on hints overwhelming, and you may prefer to remove temptation by disabling hints for the rest of this game. If you do so, however, you will not be able to access the hints unless you restart. Do you wish to disable hints? >

>n
Okay - but if you change your mind later you can use the HINTS OFF command to disable hints.

 > Finding stuff in the jail cell
   How does that steam contraption work?

>
   Finding stuff in the jail cell
 > How does that steam contraption work?
   Finding stuff in the jail cell
 > How does that steam contraption work?

1/17: The deputy mentioned that the sheriff is an inventor, and there's this big old boiler in the middle of the sheriff's office. The deputy's dog, Flash, is tied to a lever on that machine.

Press SPACE to return to the menu or H to reveal another hint.

>h
1/17: The deputy mentioned that the sheriff is an inventor, and there's this big old boiler in the middle of the sheriff's office. The deputy's dog, Flash, is tied to a lever on that machine.

2/17: The lever looks like it could either swing towards or away from you.

Press SPACE to return to the menu or H to reveal another hint.

>h
1/17: The deputy mentioned that the sheriff is an inventor, and there's this big old boiler in the middle of the sheriff's office. The deputy's dog, Flash, is tied to a lever on that machine.

2/17: The lever looks like it could either swing towards or away from you.

3/17: The deputy said he was tying Flash to the lever so that if you made a break for the door, Flash would set off the train whistle on the roof.

Press SPACE to return to the menu or H to reveal another hint.

>h
1/17: The deputy mentioned that the sheriff is an inventor, and there's this big old boiler in the middle of the sheriff's office. The deputy's dog, Flash, is tied to a lever on that machine.

2/17: The lever looks like it could either swing towards or away from you.

3/17: The deputy said he was tying Flash to the lever so that if you made a break for the door, Flash would set off the train whistle on the roof.

4/17: The lever is attached to a junction in the pipe and it looks like it can direct the flow of steam either upwards towards the roof or across the office and into the strange machine.

Press SPACE to return to the menu or H to reveal another hint.

>h
1/17: The deputy mentioned that the sheriff is an inventor, and there's this big old boiler in the middle of the sheriff's office. The deputy's dog, Flash, is tied to a lever on that machine.

2/17: The lever looks like it could either swing towards or away from you.

3/17: The deputy said he was tying Flash to the lever so that if you made a break for the door, Flash would set off the train whistle on the roof.

4/17: The lever is attached to a junction in the pipe and it looks like it can direct the flow of steam either upwards towards the roof or across the office and into the strange machine.

5/17: Flash can move the lever by either walking towards or away from the jail cell.

Press SPACE to return to the menu or H to reveal another hint.

>h
1/17: The deputy mentioned that the sheriff is an inventor, and there's this big old boiler in the middle of the sheriff's office. The deputy's dog, Flash, is tied to a lever on that machine.

2/17: The lever looks like it could either swing towards or away from you.

3/17: The deputy said he was tying Flash to the lever so that if you made a break for the door, Flash would set off the train whistle on the roof.

4/17: The lever is attached to a junction in the pipe and it looks like it can direct the flow of steam either upwards towards the roof or across the office and into the strange machine.

5/17: Flash can move the lever by either walking towards or away from the jail cell.

6/17: If Flash walks away from the jail cell, he'll pull the lever and set off the train whistle.

Press SPACE to return to the menu or H to reveal another hint.

>h
1/17: The deputy mentioned that the sheriff is an inventor, and there's this big old boiler in the middle of the sheriff's office. The deputy's dog, Flash, is tied to a lever on that machine.

2/17: The lever looks like it could either swing towards or away from you.

3/17: The deputy said he was tying Flash to the lever so that if you made a break for the door, Flash would set off the train whistle on the roof.

4/17: The lever is attached to a junction in the pipe and it looks like it can direct the flow of steam either upwards towards the roof or across the office and into the strange machine.

5/17: Flash can move the lever by either walking towards or away from the jail cell.

6/17: If Flash walks away from the jail cell, he'll pull the lever and set off the train whistle.

7/17: If Flash walks towards the jail cell, he'll pull the lever in the other direction and direct steam to the machine.

Press SPACE to return to the menu or H to reveal another hint.

>h
1/17: The deputy mentioned that the sheriff is an inventor, and there's this big old boiler in the middle of the sheriff's office. The deputy's dog, Flash, is tied to a lever on that machine.

2/17: The lever looks like it could either swing towards or away from you.

3/17: The deputy said he was tying Flash to the lever so that if you made a break for the door, Flash would set off the train whistle on the roof.

4/17: The lever is attached to a junction in the pipe and it looks like it can direct the flow of steam either upwards towards the roof or across the office and into the strange machine.

5/17: Flash can move the lever by either walking towards or away from the jail cell.

6/17: If Flash walks away from the jail cell, he'll pull the lever and set off the train whistle.

7/17: If Flash walks towards the jail cell, he'll pull the lever in the other direction and direct steam to the machine.

8/17: When have you seen Flash move quickly? Is there anything that motivates him?

Press SPACE to return to the menu or H to reveal another hint.

>h
1/17: The deputy mentioned that the sheriff is an inventor, and there's this big old boiler in the middle of the sheriff's office. The deputy's dog, Flash, is tied to a lever on that machine.

2/17: The lever looks like it could either swing towards or away from you.

3/17: The deputy said he was tying Flash to the lever so that if you made a break for the door, Flash would set off the train whistle on the roof.

4/17: The lever is attached to a junction in the pipe and it looks like it can direct the flow of steam either upwards towards the roof or across the office and into the strange machine.

5/17: Flash can move the lever by either walking towards or away from the jail cell.

6/17: If Flash walks away from the jail cell, he'll pull the lever and set off the train whistle.

7/17: If Flash walks towards the jail cell, he'll pull the lever in the other direction and direct steam to the machine.

8/17: When have you seen Flash move quickly? Is there anything that motivates him?

9/17: The food bowl is near the jail cell. How can you make Flash walk towards it?

Press SPACE to return to the menu or H to reveal another hint.

>h
1/17: The deputy mentioned that the sheriff is an inventor, and there's this big old boiler in the middle of the sheriff's office. The deputy's dog, Flash, is tied to a lever on that machine.

2/17: The lever looks like it could either swing towards or away from you.

3/17: The deputy said he was tying Flash to the lever so that if you made a break for the door, Flash would set off the train whistle on the roof.

4/17: The lever is attached to a junction in the pipe and it looks like it can direct the flow of steam either upwards towards the roof or across the office and into the strange machine.

5/17: Flash can move the lever by either walking towards or away from the jail cell.

6/17: If Flash walks away from the jail cell, he'll pull the lever and set off the train whistle.

7/17: If Flash walks towards the jail cell, he'll pull the lever in the other direction and direct steam to the machine.

8/17: When have you seen Flash move quickly? Is there anything that motivates him?

9/17: The food bowl is near the jail cell. How can you make Flash walk towards it?

10/17: How did the deputy let Flash know he a some food for him?

Press SPACE to return to the menu or H to reveal another hint.

>h
1/17: The deputy mentioned that the sheriff is an inventor, and there's this big old boiler in the middle of the sheriff's office. The deputy's dog, Flash, is tied to a lever on that machine.

2/17: The lever looks like it could either swing towards or away from you.

3/17: The deputy said he was tying Flash to the lever so that if you made a break for the door, Flash would set off the train whistle on the roof.

4/17: The lever is attached to a junction in the pipe and it looks like it can direct the flow of steam either upwards towards the roof or across the office and into the strange machine.

5/17: Flash can move the lever by either walking towards or away from the jail cell.

6/17: If Flash walks away from the jail cell, he'll pull the lever and set off the train whistle.

7/17: If Flash walks towards the jail cell, he'll pull the lever in the other direction and direct steam to the machine.

8/17: When have you seen Flash move quickly? Is there anything that motivates him?

9/17: The food bowl is near the jail cell. How can you make Flash walk towards it?

10/17: How did the deputy let Flash know he a some food for him?

11/17: Flash has been conditioned to respond to the dinner bell by running towards his food bowl.

Press SPACE to return to the menu or H to reveal another hint.

>h
1/17: The deputy mentioned that the sheriff is an inventor, and there's this big old boiler in the middle of the sheriff's office. The deputy's dog, Flash, is tied to a lever on that machine.

2/17: The lever looks like it could either swing towards or away from you.

3/17: The deputy said he was tying Flash to the lever so that if you made a break for the door, Flash would set off the train whistle on the roof.

4/17: The lever is attached to a junction in the pipe and it looks like it can direct the flow of steam either upwards towards the roof or across the office and into the strange machine.

5/17: Flash can move the lever by either walking towards or away from the jail cell.

6/17: If Flash walks away from the jail cell, he'll pull the lever and set off the train whistle.

7/17: If Flash walks towards the jail cell, he'll pull the lever in the other direction and direct steam to the machine.

8/17: When have you seen Flash move quickly? Is there anything that motivates him?

9/17: The food bowl is near the jail cell. How can you make Flash walk towards it?

10/17: How did the deputy let Flash know he a some food for him?

11/17: Flash has been conditioned to respond to the dinner bell by running towards his food bowl.

12/17: The dinner bell is hanging on a hook near the front door, inconveniently distant for someone stuck in a jail cell.

Press SPACE to return to the menu or H to reveal another hint.

>h
1/17: The deputy mentioned that the sheriff is an inventor, and there's this big old boiler in the middle of the sheriff's office. The deputy's dog, Flash, is tied to a lever on that machine.

2/17: The lever looks like it could either swing towards or away from you.

3/17: The deputy said he was tying Flash to the lever so that if you made a break for the door, Flash would set off the train whistle on the roof.

4/17: The lever is attached to a junction in the pipe and it looks like it can direct the flow of steam either upwards towards the roof or across the office and into the strange machine.

5/17: Flash can move the lever by either walking towards or away from the jail cell.

6/17: If Flash walks away from the jail cell, he'll pull the lever and set off the train whistle.

7/17: If Flash walks towards the jail cell, he'll pull the lever in the other direction and direct steam to the machine.

8/17: When have you seen Flash move quickly? Is there anything that motivates him?

9/17: The food bowl is near the jail cell. How can you make Flash walk towards it?

10/17: How did the deputy let Flash know he a some food for him?

11/17: Flash has been conditioned to respond to the dinner bell by running towards his food bowl.

12/17: The dinner bell is hanging on a hook near the front door, inconveniently distant for someone stuck in a jail cell.

13/17: To ring the bell, you'll need to hit the bell with something.

Press SPACE to return to the menu or H to reveal another hint.

>h
1/17: The deputy mentioned that the sheriff is an inventor, and there's this big old boiler in the middle of the sheriff's office. The deputy's dog, Flash, is tied to a lever on that machine.

2/17: The lever looks like it could either swing towards or away from you.

3/17: The deputy said he was tying Flash to the lever so that if you made a break for the door, Flash would set off the train whistle on the roof.

4/17: The lever is attached to a junction in the pipe and it looks like it can direct the flow of steam either upwards towards the roof or across the office and into the strange machine.

5/17: Flash can move the lever by either walking towards or away from the jail cell.

6/17: If Flash walks away from the jail cell, he'll pull the lever and set off the train whistle.

7/17: If Flash walks towards the jail cell, he'll pull the lever in the other direction and direct steam to the machine.

8/17: When have you seen Flash move quickly? Is there anything that motivates him?

9/17: The food bowl is near the jail cell. How can you make Flash walk towards it?

10/17: How did the deputy let Flash know he a some food for him?

11/17: Flash has been conditioned to respond to the dinner bell by running towards his food bowl.

12/17: The dinner bell is hanging on a hook near the front door, inconveniently distant for someone stuck in a jail cell.

13/17: To ring the bell, you'll need to hit the bell with something.

14/17: You need to look around a bit more to find some means of ringing the bell.

Press SPACE to return to the menu or H to reveal another hint.

>h
1/17: The deputy mentioned that the sheriff is an inventor, and there's this big old boiler in the middle of the sheriff's office. The deputy's dog, Flash, is tied to a lever on that machine.

2/17: The lever looks like it could either swing towards or away from you.

3/17: The deputy said he was tying Flash to the lever so that if you made a break for the door, Flash would set off the train whistle on the roof.

4/17: The lever is attached to a junction in the pipe and it looks like it can direct the flow of steam either upwards towards the roof or across the office and into the strange machine.

5/17: Flash can move the lever by either walking towards or away from the jail cell.

6/17: If Flash walks away from the jail cell, he'll pull the lever and set off the train whistle.

7/17: If Flash walks towards the jail cell, he'll pull the lever in the other direction and direct steam to the machine.

8/17: When have you seen Flash move quickly? Is there anything that motivates him?

9/17: The food bowl is near the jail cell. How can you make Flash walk towards it?

10/17: How did the deputy let Flash know he a some food for him?

11/17: Flash has been conditioned to respond to the dinner bell by running towards his food bowl.

12/17: The dinner bell is hanging on a hook near the front door, inconveniently distant for someone stuck in a jail cell.

13/17: To ring the bell, you'll need to hit the bell with something.

14/17: You need to look around a bit more to find some means of ringing the bell.

15/17: You could spit something at the bell.

Press SPACE to return to the menu or H to reveal another hint.

>h
1/17: The deputy mentioned that the sheriff is an inventor, and there's this big old boiler in the middle of the sheriff's office. The deputy's dog, Flash, is tied to a lever on that machine.

2/17: The lever looks like it could either swing towards or away from you.

3/17: The deputy said he was tying Flash to the lever so that if you made a break for the door, Flash would set off the train whistle on the roof.

4/17: The lever is attached to a junction in the pipe and it looks like it can direct the flow of steam either upwards towards the roof or across the office and into the strange machine.

5/17: Flash can move the lever by either walking towards or away from the jail cell.

6/17: If Flash walks away from the jail cell, he'll pull the lever and set off the train whistle.

7/17: If Flash walks towards the jail cell, he'll pull the lever in the other direction and direct steam to the machine.

8/17: When have you seen Flash move quickly? Is there anything that motivates him?

9/17: The food bowl is near the jail cell. How can you make Flash walk towards it?

10/17: How did the deputy let Flash know he a some food for him?

11/17: Flash has been conditioned to respond to the dinner bell by running towards his food bowl.

12/17: The dinner bell is hanging on a hook near the front door, inconveniently distant for someone stuck in a jail cell.

13/17: To ring the bell, you'll need to hit the bell with something.

14/17: You need to look around a bit more to find some means of ringing the bell.

15/17: You could spit something at the bell.

16/17: Have you found the chewing tobacco?

Press SPACE to return to the menu or H to reveal another hint.

>h
1/17: The deputy mentioned that the sheriff is an inventor, and there's this big old boiler in the middle of the sheriff's office. The deputy's dog, Flash, is tied to a lever on that machine.

2/17: The lever looks like it could either swing towards or away from you.

3/17: The deputy said he was tying Flash to the lever so that if you made a break for the door, Flash would set off the train whistle on the roof.

4/17: The lever is attached to a junction in the pipe and it looks like it can direct the flow of steam either upwards towards the roof or across the office and into the strange machine.

5/17: Flash can move the lever by either walking towards or away from the jail cell.

6/17: If Flash walks away from the jail cell, he'll pull the lever and set off the train whistle.

7/17: If Flash walks towards the jail cell, he'll pull the lever in the other direction and direct steam to the machine.

8/17: When have you seen Flash move quickly? Is there anything that motivates him?

9/17: The food bowl is near the jail cell. How can you make Flash walk towards it?

10/17: How did the deputy let Flash know he a some food for him?

11/17: Flash has been conditioned to respond to the dinner bell by running towards his food bowl.

12/17: The dinner bell is hanging on a hook near the front door, inconveniently distant for someone stuck in a jail cell.

13/17: To ring the bell, you'll need to hit the bell with something.

14/17: You need to look around a bit more to find some means of ringing the bell.

15/17: You could spit something at the bell.

16/17: Have you found the chewing tobacco?

17/17: Alternatively, you could try to shoot the bell, if you had something that you could aim accurately.

Press SPACE to return to the menu.

   Finding stuff in the jail cell
 > How does that steam contraption work?
   Finding stuff in the jail cell
 > How does that steam contraption work?

>þ
   Finding stuff in the jail cell
 > How does that steam contraption work?

>q
Jail Cell
The small jail cell is brick on three sides, metal bars on the other, with a tightly locked gate. A small window is set into the brickwork above your head. Through the jail bars you can see the sheriff's office.

A broken stool lies on the floor.

Muddy leans against the wall.

In the corner of the cell, a disheveled man in a black suit is stretched out on a crude wooden bench and is snoring loudly, oblivious to your presence.

You can also see a can of beans (in which is a spoon) and a hunk of meat here.

>get tin
You borrow Pete's tin of chewing tobacco. It don't look like he'll mind seeing as how he's unconscious and all.

>hint
 > Finding stuff in the jail cell
   How does that steam contraption work?

>
   Finding stuff in the jail cell
 > How does that steam contraption work?
   Finding stuff in the jail cell
 > How does that steam contraption work?

1/17: The deputy mentioned that the sheriff is an inventor, and there's this big old boiler in the middle of the sheriff's office. The deputy's dog, Flash, is tied to a lever on that machine.

2/17: The lever looks like it could either swing towards or away from you.

3/17: The deputy said he was tying Flash to the lever so that if you made a break for the door, Flash would set off the train whistle on the roof.

4/17: The lever is attached to a junction in the pipe and it looks like it can direct the flow of steam either upwards towards the roof or across the office and into the strange machine.

5/17: Flash can move the lever by either walking towards or away from the jail cell.

6/17: If Flash walks away from the jail cell, he'll pull the lever and set off the train whistle.

7/17: If Flash walks towards the jail cell, he'll pull the lever in the other direction and direct steam to the machine.

8/17: When have you seen Flash move quickly? Is there anything that motivates him?

9/17: The food bowl is near the jail cell. How can you make Flash walk towards it?

10/17: How did the deputy let Flash know he a some food for him?

11/17: Flash has been conditioned to respond to the dinner bell by running towards his food bowl.

12/17: The dinner bell is hanging on a hook near the front door, inconveniently distant for someone stuck in a jail cell.

13/17: To ring the bell, you'll need to hit the bell with something.

14/17: From what you've already discovered in the cell, you already have at least one means of ringing the bell.

15/17: You could spit something at the bell.

16/17: Have you found the chewing tobacco?

17/17: Alternatively, you could try to shoot the bell, if you had something that you could aim accurately.

Press SPACE to return to the menu or H to reveal another hint.

   Finding stuff in the jail cell
 > How does that steam contraption work?
   Finding stuff in the jail cell
 > How does that steam contraption work?

* * *

>ask muddy about plan
I already done told you -- we got to bust out.

"That worked out well," says Muddy proudly.

"For you maybe," you reply. "But I near as lost my lunch what with that stench."

To which Muddy counters, "Ain't much worse than your feet, I reckon."

>hint
Some players may find the temptation to rely on hints overwhelming, and you may prefer to remove temptation by disabling hints for the rest of this game. If you do so, however, you will not be able to access the hints unless you restart. Do you wish to disable hints? >

>n
Okay - but if you change your mind later you can use the HINTS OFF command to disable hints.

 > Finding stuff in the jail cell

1/6: To get out of the jail cell, you're going to need to make the best use of what's at hand.

Press SPACE to return to the menu or H to reveal another hint.

 > Finding stuff in the jail cell
 > Finding stuff in the jail cell

* * *

>z
Time passes.

Muddy wraps his arms around his belly, and moans softly, "I might have overdone it with them beans."

The deputy looks up from his reading, curious. 

"Ain't you gonna ask me about my plan?" Muddy whispers.

>show watch to muddy
Muddy takes a look at the pocketwatch and says, "I ain't never seen you without it."

Muddy doubles over, "Rick, you should get to high ground. I'm feeling a mite bloated after them beans, and I think you know what's coming!"

"Where the Sam Hill do you think I'm going to run to, Muddy? We're locked up in a hoosegow! Deputy, if'n I was you, I would put some distance between Muddy and your nose. "

The Deputy looks concerned, but confused. 

"This time my plan is sure fire -- go ahead, ask me. C'mon." Muddy jibes quietly.

>ask muddy about his plan
"Let's keep this between us, though", he whispers.

He notices the sleeping man in your cell for the first time. "Don't know about him." Muddy jerks his thumb towards the sleeping figure. "Might be a spy."

Muddy leans towards you, his face barely an inch from your ear and his buzzard-worthy breath even less so from your nose. "Okay, Rick, I'm a-going to tell my plan." Muddy pauses dramatically. "Here it is: we got to break out of this jail before we get strunged up."

"That's it? That's your whole damn plan? That don't count as no plan!" you fume.

"Keep it down, Rick!" Muddy's gaze darts between the deputy and your third cellmate. "Yeah, that's it for now. It takes time to cook up a good plan. You need lots of ingredients."

"Muddy Charlie," you retort, "I heared you was the worst cook in the Confederate Army. Your cooking like as did more damage than Sherman's March."

Muddy gives you a hurt look and sulks in the corner. After a while, you regret being so quick-tempered with your old buddy.

You hear nothing. The smell nearly knocks you out. Vision fades, the room spins.

Muddy whispers in that understated manner of his, "That were a silent but deadly."

>i
You're carrying a spur, your pocketwatch, and a scrap of paper. You are wearing your hat, pants, overcoat, left boot, and right boot. 

Your revolver was confiscated, it seems.

Suppressing the urge to throw up from the smell, the deputy reaches over to the whiskey bottle and half drains it on his way out the door.

The fragrance gradually improves as the universe cools.
[Your score has just gone up by one]

>i
You're carrying a spur, your pocketwatch, and a scrap of paper. You are wearing your hat, pants, overcoat, left boot, and right boot.

>show pocketwatch to muddy
Muddy takes a look at the pocketwatch and says, "I ain't never seen you without it."

The deputy pokes his head back in the office and remarks, "I've about had enough of you characters. You can stew in your own juices here. I got important things to do over yonder in the saloon. But I reckon I would be dairy licked to leave you jokers alone."

The deputy grabs a dinner bell from the hook where it hangs next to the office door, and he rings the bell slowly a few times. Nothing happens. He rings it again. Minutes go by and the deputy waits impatiently. Finally, a fat bloodhound waddles leisurely through the door way, tempted by the dinner bell.

The deputy reaches into his pocket and retrieves a scrap of beef jerky. He pitches it into the dog's bowl and the bloodhound gobbles it down. The deputy leads his mangy old dog towards the office's strange looking steam boiler and ties him to it with a leash.

"This here's Flash, my hunting dog. I got to warn you that he can be vicious when he gets riled up, so don't cross him." Flash slowly slumps down next to the boiler, enjoying the heat. His heavy eyes close and drool drips from his toothless mouth.

"Flash here's apt to rip your throat out if you so much as look at him funny, but I got him hooked up here to the sheriff's fancy steam contraption." The deputy narrows his eyes distrustfully. "If you boys were so stupid as to make for the jailhouse door, 'ol Flash would yank that lever and set off the steam whistle on the roof. The sheriff installed it special for me, so as I can come when he wants me. I can hear that half way across town, and if'n I do hear it, then you'll have to deal with me *and* Flash." The deputy gives Flash one last pat on the head, swigs the whiskey one more time, and departs for the saloon.

>get can of beans
Fetched.

Muddy paces back and forth impatiently. 

"That worked out well," says Muddy proudly.

"For you maybe," you reply. "But I near as lost my lunch what with that stench."

To which Muddy counters, "Ain't much worse than your feet, I reckon."

>show can of beans to muddy
Muddy grunts, unimpressed.

>get meat
Yuck. You are holding the rancid meat.

Fetched.

>show meat to muddy
Muddy takes a look at the meat and says, "I'll eat almost anything. Almost."

Flash has died. Wait. Sorry. He's just really immobile.

>get spoon
Fetched.

>show spoon to muddy
Muddy takes a look at the spoon and says, "They're good for making music."

>purloin warrant
[Purloined.]

>show warrant to muddy
"Muddy, this here's a federal warrant!"

"What's it say, Rick?"

I'm a-reading it now: FEDERAL WARRANT. This warrant is issued this eleventh day of December in the year of Our Lord Eighteen Hundred and Seventy-One and duly executed by the hand of United States Army Major General Philip H. Sheridan of Fort Sill, the Indian Territory of these United States of America. The fugitives Mudlark Abercromby MacGyver alias "Muddy," alias "Mudshoe," alias "Pensicola Thelma," and one Major Richard Carter, alias "Gentleman Rick," alias "Poor Richard," alias "Gumball Ricky," both formerly of the Confederate States Army, having been implicated by observation and circumstance of innumerable delicta, dacoiteries, iniquities, infringements, infractions, and indeed immorality, as well as trangressions, trespassing and trainstopping, are considered deleterious and detrimental to the welfare of the State, and THEREFORE, ordered thereupon that a Mittimus be made out to keep them confined until such time as they be discharged for proper hanging -- It's signed by the General."

"Mittimus?"

"I reckon it's after Thanksgiving, before Easter."

Muddy gives you that familiar old look that always leads to trouble. "I got me another cunning plan. C'mon, ask your old buddy Muddy..." Muddy leans forward, clearly impatient for you to ask him about his latest stroke of (in his opinion) genius."

>i
You're carrying a warrant, a spoon, a hunk of meat, a can of beans, a spur, your pocketwatch, and a scrap of paper. You are wearing your hat, pants, overcoat, left boot, and right boot. 

"No, really. This plan is a winner. I'm dying for you to ask me about it. You'll see. This one will work." Muddy looks desperate to prove himself to you.

>i
You're carrying a warrant, a spoon, a hunk of meat, a can of beans, a spur, your pocketwatch, and a scrap of paper. You are wearing your hat, pants, overcoat, left boot, and right boot. 

"I know some of my plans haven't panned out entirely, but I see a way clear out of this jail. Go on, ask me." It's like the years have caught up to Muddy, and he wants this one more chance to do right by you. 

Flash drools.

>show spoon to muddy
Muddy takes a look at the spoon and says, "They're good for making music."

"Rick, will you trust me on this one? Ask me my plan." Muddy looks at the ground, despondent that you are ignoring him.

>purloin bell
[Purloined.]

>show bell to muddy
Muddy takes a look at the bell and says, "I reckon it's a dinner bell."

Muddy fidgets. No longer unable to contain himself, he blurts out, "Oh for the sake of criminy, I got to tell you!" 

Muddy says excitedly, "Here's my idea: I reckon I could take that warrant and forge a different ending. Maybe trick them into releasing us."

"That's a great idea, Muddy, let me get my pen and some ink. Oh, wait a minute. I don't have either!" You glare at Muddy.

"Oh, yeah. I suppose. I didn't think of that." Muddy considers the matter. "Maybe we could make one. If you can find something that I can use as a pen, I reckon that one of them red berries would make a right proper kind of ink for it."

>show can of beans to deputy
You ain't able to see no such thing.

>purloin can of beans
[Purloined.]

>show can of beans to deputy
You ain't able to see no such thing.

>i
You're carrying a can of beans, a bell, a warrant, a spoon, a hunk of meat, a spur, your pocketwatch, and a scrap of paper. You are wearing your hat, pants, overcoat, left boot, and right boot.

>x can of beans
An open metal can with a paper label saying "BEANS". On the back, some fine print says, "Precooked beans. No claim is made regarding the cardioprotective nature of this product. May cause abdominal distension if ingested. No fitness of purpose is implied. No warranty is provided for personal or other injury, or injury or loss related directly or indirectly to the use of this product. By opening this can, you agree to the terms of service posted in town."

>show warrant to deputy
You ain't able to see no such thing.

>i
You're carrying a can of beans, a bell, a warrant, a spoon, a hunk of meat, a spur, your pocketwatch, and a scrap of paper. You are wearing your hat, pants, overcoat, left boot, and right boot.

* * *

>show right boot to muddy
Muddy grunts, unimpressed.

>purloin gun
[Purloined.]

>show gun to muddy
Muddy takes a look at the gun and says, "I prefer my own gun. A man ought have feelings for his gun, and I most surely do."

>purlon meat
That ain't no verb I got knowledge of.

>purloin meat
[Purloined.]

>show meat to muddy
Muddy takes a look at the meat and says, "I'll eat almost anything. Almost."

>purloin can of beans
[Purloined.]

>i
You're carrying a can of beans, a hunk of meat, your gun, your pocketwatch, and a scrap of paper. You are wearing your hat, pants, overcoat, left boot, and right boot. 

Your revolver was confiscated, it seems.

In the office, the deputy makes you nervous as he waves his gun back and forth, jerking the barrel up and shaping the words "Pow! Pow!" with his lips.

>x can of beans
A closed metal can with a paper label saying "BEANS". On the back, some fine print says, "Precooked beans. No claim is made regarding the cardioprotective nature of this product. May cause abdominal distension if ingested. No fitness of purpose is implied. No warranty is provided for personal or other injury, or injury or loss related directly or indirectly to the use of this product. By opening this can, you agree to the terms of service posted in town."

>show can of beans to mudy
You ain't able to see no such thing.

>show can of beans to muddy
Muddy grunts, unimpressed.

>get spoon
You ain't able to see no such thing.

>look under bench
Under the bench, you notice the remnants of a meal.

It feels cooler than it did last night.

>show spoon to muddy
(first taking the spoon)
Muddy takes a look at the spoon and says, "They're good for making music."

>show spoon to deputy
The deputy looks irked, but looks over at the spoon and says, "To get every drop."

Over in the office, the deputy watches you with a bored expression.

>purloin holster
[Can't move holster: it's part of the gun belt.]

>purloin gun belt
[Purloined.]

>show gun belt to deputy
Um.

On the other side of the jail bars in the office, the deputy looks tired.

>show gun belt to muddy
Muddy takes a look at the gun belt and says, "I prefer my own gun. A man ought have feelings for his gun, and I most surely do."

>get tin
You borrow Pete's tin of chewing tobacco. It don't look like he'll mind seeing as how he's unconscious and all.

In the office, the deputy reaches into his pocket, produces a strip of beef jerky and chews on it for a while.

>show tin to muddy
Muddy grunts, unimpressed.

On the other side of the jail bars in the office, the deputy inspects his LeMat revolver lovingly.

>show tin to deputy
The deputy isn't impressed.

Over in the office, the deputy warms his hands near the boiler.

* * *

>þ
In the twilight, you sight the sheriff's sturdy brick office near the edge of town. "That's mighty fine construction," notes Muddy, sounding less feisty now. "Mighty fine indeed." The coach rolls to a halt and a thick arm yanks you roughly from your seat. You land awkwardly in the rutted street, where the sheriff holds you in place with the heel of one boot. He yells to his men, "Bring the coach around back, we got to impound that evidence." You are shoved into the sheriff's office and then into a small holding cell.

The deputy wakes with a start, whips his dusty boots off the desk and stands, tucking his shirt back into his pants. The sheriff gives him a brief, judgmental glance and offhandedly tosses an arrest warrant on the desk. He barks, "Jimbo, listen up. Picked up these two down near the train. A federal marshal will be coming for them at eight o'clock tomorrow morning. There's going to be a hanging!". The deputy nods slowly. The sheriff continues, "Please take care of our 'guests'. I got to head down to Wichita Falls to discuss my invention with some investors, so you is in charge." The deputy smiles until the sheriff adds, "Jimbo, don't screw up," as he heads out the door.

Jail Cell
Why are you not surprised to have landed right back in the hoosegow after another one of Muddy's dubious plans? Will you ever learn? You weren't brought up for this sort of life -- how did it come to this? 

The small jail cell is brick on three sides, metal bars on the other, with a tightly locked gate. A small window is set into the brickwork above your head. Through the jail bars you can see the sheriff's office.

A broken stool lies on the floor.

Muddy leans against the wall tapping a harmonica on his arm.

In the corner of the cell, a disheveled man in a black suit is stretched out on a crude wooden bench and is snoring loudly, oblivious to your presence.

* * *

>y
In the twilight, you sight the sheriff's sturdy brick office near the edge of town. "That's mighty fine construction," notes Muddy, sounding less feisty now. "Mighty fine indeed." The coach rolls to a halt and a thick arm yanks you roughly from your seat. You land awkwardly in the rutted street, where the sheriff holds you in place with the heel of one boot. He yells to his men, "Bring the coach around back, we got to impound that evidence." You are shoved into the sheriff's office and then into a small holding cell.

The deputy wakes with a start, whips his dusty boots off the desk and stands, tucking his shirt back into his pants. The sheriff gives him a brief, judgmental glance and offhandedly tosses an arrest warrant on the desk. He barks, "Jimbo, listen up. Picked up these two down near the train. A federal marshal will be coming for them at eight o'clock tomorrow morning. There's going to be a hanging!". The deputy nods slowly. The sheriff continues, "Please take care of our 'guests'. I got to head down to Wichita Falls to discuss my invention with some investors, so you is in charge." The deputy smiles until the sheriff adds, "Jimbo, don't screw up," as he heads out the door.

Jail Cell
Why are you not surprised to have landed right back in the hoosegow after another one of Muddy's dubious plans? Will you ever learn? You weren't brought up for this sort of life -- how did it come to this? 

The small jail cell is brick on three sides, metal bars on the other, with a tightly locked gate. A small window is set into the brickwork above your head. Through the jail bars you can see the sheriff's office.

A broken stool lies on the floor.

Muddy leans against the wall tapping a harmonica on his arm.

In the corner of the cell, a disheveled man in a black suit is stretched out on a crude wooden bench and is snoring loudly, oblivious to your presence.

>climb window
Those rods aren't going anywhere; at most, you can maybe reach your hand through them.

In the office, the deputy repeatedly counts his fingers, but is unable to get a firm answer.

>g
Those rods aren't going anywhere; at most, you can maybe reach your hand through them.

Back in the office, the deputy runs his hand through his sparse hair.

>climb stool
The deputy folds down the warrant he is reading and smiles encouragingly, "Please, go ahead. The stool is stronger than it looks."

You sit down on the precariously balanced two-legged stool and subsequently find yourself face down on the dusty jail floor. Muddy helps you up and brushes you off. 

The deputy laughs himself hoarse. "I declare, that were powerful entertaining!" The deputy continues to chuckle to himself, even as he turns back to his newspaper, "I said, please go ahead, and he sits on it. That were rich. Maybe he'll try again."

In the office, the deputy peeks through the jail cell window at the saloon across the street. It's clear he'd rather be there.

>enter window
Those rods aren't going anywhere; at most, you can maybe reach your hand through them.