As the sun sets on the plains, the sheriff angrily snaps on the cuffs. You are shoved into the coach and land on top of Muddy Charlie and the pile of silver dollars, which until recently had been the property of the Missouri, Kansas & Texas Line.

Muddy furtively whispers, "Hang tight, Rick! You done good blowing up that tunnel -- I just didn't plan on the sheriff getting word ahead of time, is all. That were powerful bad luck."

The sheriff climbs onto his horse, spits, and you begin to rumble forward. "You boys really got it coming this time," he yells back cheerfully.

Muddy shakes his head. "No offense, Sheriff, but I reckon you got the wrong men. We was just on our way to the theater."

The sheriff disagrees. "The only place you boys are heading is straight to the... 

Hoosegow
A Wild West Wreck by Ben Collins-Sussman and Jack Welch
Release 1 / Serial number 100117 / Inform 7 build 5Z71 (I6/v6.31 lib 6/12N) SD
Type "help" for instructions, credits, and license -- or just roll into town guns a-blazin'.

[Press Space To Continue]

In the twilight, you sight the sheriff's sturdy brick office near the edge of town. "That's mighty fine construction," notes Muddy, sounding less feisty now. "Mighty fine indeed." The coach rolls to a halt and a thick arm yanks you roughly from your seat. You land awkwardly in the rutted street, where the sheriff holds you in place with the heel of one boot. He yells to his men, "Bring the coach on around, we got to impound that evidence." You are manhandled into the sheriff's office and shoved into a small holding cell.

The deputy wakes with a start, whips his dusty boots off the desk and stands, tucking his shirt back into his pants. The sheriff gives him a brief, judgmental glance and offhandedly tosses an arrest warrant on the desk. He barks, "Jimbo, listen up. Picked up these two down near the train. A federal marshal will be coming for them at eight o'clock tomorrow morning. There's going to be a hanging!". The deputy nods slowly. The sheriff continues, "Please take care of our 'guests'. I got to head down to Wichita Falls to discuss my invention with some investors, so you is in charge." The deputy smiles until the sheriff adds, "Jimbo, don't screw up," as he heads out the door.

Jail Cell
Why are you not surprised to have landed right back in the hoosegow after another one of Muddy's dubious plans? Will you ever learn? You weren't brought up for this sort of life -- how did it come to this? 

The small jail cell is brick on three sides, metal bars on the other, with a tightly locked gate.  A small window is set into the brickwork above your head.  Through the jail bars you can see the sheriff's office.

A broken stool lies on the floor.

In the corner of the cell, Muddy leans against the wall tapping a harmonica on his arm.

Across the cell from you, a disheveled man in a black suit is stretched out on a crude wooden bench and is snoring loudly, oblivious to your presence.

In the office you can see a deputy.

>x boots
Black boots that have seen better days. The left boot is missing its heel spur.

Back in the office, the deputy peeks through the jail cell window at the saloon across the street. It's clear he'd rather be there.

>remove boot
Which all do you mean, the left boot, or the right boot?

* * *

>smell
The whole place reeks of cheap cigar smoke.

On the other side of the jail bars in the office, the deputy sniffles loudly and wipes his nose on his sleeve.

>remove boot
(the right boot)
Oh, you really don't want to do that. Not indoors at least. Are you sure?

(yes or no) >

>yes
You rock back and forth on the floor, locked in a death struggle with your foot. Beads of sweat form on your head, as you struggle to twist and pull the boot off. With a sudden sucking pop, the boot relents and you tumble backwards.

Muddy's eyes water as he complains, "Not again! My poor nose!"

The Deputy's cigar seems to shrivel and hang limply in his mouth, as its prodigious odor is astronomically outclassed by the combined stench of your two feet. Suppressing the urge to throw up from the smell, the deputy reaches over to the whiskey bottle and half drains it on his way out the door.

After he leaves, you give in to Muddy's desperate pleas to put your boots back on.

The fragrance gradually improves as the universe cools.

>smell
It stinks to high heaven.

>z
Time passes.

The deputy pokes his head back in the office and remarks, "I've about had enough of you characters. You can stew in your own juices here. I got important things to do over yonder in the saloon. But I reckon I would be dairy licked to leave you jokers alone."

The deputy grabs a dinner bell from the hook where it hangs next to the office door, and he rings the bell slowly a few times. Nothing happens. He rings it again. Minutes go by, and the deputy waits impatiently. Finally, a fat bloodhound waddles leisurely through the door way, tempted by the dinner bell.

The deputy reaches into his pocket and retrieves a scrap of beef jerky. He pitches it into the dog's bowl and the bloodhound gobbles it down. The deputy leads his mangy old dog towards the office's strange looking steam boiler and ties him to it with a leash.

"This here's Flash, my hunting dog. I got to warn you that he can be vicious when he gets riled up, so don't cross him." Flash slowly slumps down next to the boiler, enjoying the heat. His heavy eyes close and drool drips from his toothless mouth.

"Flash here's apt to rip your throat out if you so much as look at him funny, but I got him hooked up here to the sheriff's fancy steam contraption." The deputy narrows his eyes distrustfully. "If you boys were so stupid as to make for the jailhouse door, 'ol Flash would yank that lever and set off the steam whistle on the roof. The sheriff installed it special for me, so as I can come when he wants me. I can hear that half way across town, and if'n I do hear it, then you'll have to deal with me *and* Flash." The deputy gives Flash one last pat on the head, swigs the whiskey one more time, and departs for the saloon.

* * *

>take harmonica
"I ain't never seen you play the mouth organ, Muddy."

Your partner turns the harmonica back and forth, and a chain rattles. "That's 'cuz I ain't never learned how", he replies.

Muddy hands the harmonica to you.

>play harmonica
You tentatively blow on it a bit, but you're not rightly sure what you're doing.

The deputy grimaces, "Knock off that racket, you two. A noise like that, a man can't get to thinking straight. Settle down now, you hear? I got me some reading to do." The deputy unfolds the warrant, furrows his brow and begins reading. You can tell because his lips are moving. Slowly.

Back in the office, the deputy inspects his LeMat revolver lovingly.

>play harmonica
The deputy cringes, as you blow not only the notes that are built into the harmonica, but every note in between as well. He stands up, shoves the warrant into his pocket, and grabs a bottle of whiskey off the cabinet.

"I declare: that's just the worst thing I ever heard in my life. It's enough to drive a man to drink." To prove it, he takes a mighty swig from the whiskey bottle and wipes his mouth with the back of his sleeve. The deputy puts his fingers in his ears and tries to ignore you.

You keep playing.

The deputy balls his hands into fists and trembles with annoyance, "I'm going to the saloon to listen to some real music, from some real talented lady folk of the female persuasion." The deputy walks out the front door in a huff.

"You should hear me play piano," you remark, but he's already out of earshot.

Muddy says, "Nice one.  Hey -- I reckon I saw that screw up there wiggle a bit when you played the harmonica. I didn't say nothing on account what the deputy was here."  He points to a screw holding in one of the cell bars.

>z
Time passes.

The deputy pokes his head back in the office and remarks, "I've about had enough of you characters. You can stew in your own juices here. I got important things to do over yonder in the saloon. But I reckon I would be dairy licked to leave you jokers alone."

The deputy grabs a dinner bell from the hook where it hangs next to the office door, and he rings the bell slowly a few times. Nothing happens. He rings it again. Minutes go by, and the deputy waits impatiently. Finally, a fat bloodhound waddles leisurely through the door way, tempted by the dinner bell.

The deputy reaches into his pocket and retrieves a scrap of beef jerky. He pitches it into the dog's bowl and the bloodhound gobbles it down. The deputy leads his mangy old dog towards the office's strange looking steam boiler and ties him to it with a leash.

"This here's Flash, my hunting dog. I got to warn you that he can be vicious when he gets riled up, so don't cross him." Flash slowly slumps down next to the boiler, enjoying the heat. His heavy eyes close and drool drips from his toothless mouth.

"Flash here's apt to rip your throat out if you so much as look at him funny, but I got him hooked up here to the sheriff's fancy steam contraption." The deputy narrows his eyes distrustfully. "If you boys were so stupid as to make for the jailhouse door, 'ol Flash would yank that lever and set off the steam whistle on the roof. The sheriff installed it special for me, so as I can come when he wants me. I can hear that half way across town, and if'n I do hear it, then you'll have to deal with me *and* Flash." The deputy gives Flash one last pat on the head, swigs the whiskey one more time, and departs for the saloon.

* * *

>x bench
A long wood bench made of rough, splintery planks. Under the bench, you notice the remnants of a meal.

Back in the office, the deputy sniffles loudly and wipes his nose on his sleeve.

>x meal
On closer inspection, it looks like a rancid piece of meat, a metallic can and a spoon.

The deputy has been watching you out of the corner of his eye and he smiles sardonically. "I see you found your dinner. Or was that last week's dinner? Har, har!"

In the office, the deputy reaches into his pocket, produces a strip of beef jerk and chews on it for a while.

>take can
Fetched.

Over in the office, the deputy runs his hand through his sparse hair.

>take spoon
Fetched.

In the office, the deputy makes you nervous as he waves his gun back and forth, jerking the barrel up and shaping the words "Pow! Pow!" with his lips.

>x can
A closed metal can with a paper label saying "BEANS". On the back, some fine print says, "Precooked beans. No claim is made regarding the cardioprotective nature of this product. May cause abdominal distension if ingested. No fitness of purpose is implied. No warranty is provided for personal or other injury, or injury or loss related directly or indirectly to the use of this product. By opening this can, you agree to the terms of service posted in town."

On the other side of the jail bars in the office, the deputy stares at Muddy.

>x boots
Black boots that have seen better days. The left boot is missing its heel spur.

Back in the office, the deputy watches you with a bored expression.

>x right boot
A cowhide boot that has been rubbed smooth. A metal riding spur is about ready to fall off the worn down heel.

Over in the office, the deputy repeatedly counts his fingers, but is unable to get a firm answer.

>take spur
You yank the spur off your right boot, being careful not to cut yourself in the process.

In the office, the deputy peeks through the jail cell window at the saloon across the street. It's clear he'd rather be there. 

[Your score has just gone up by one point.]

>open can with spur
You open the can with the spur revealing the beans.

Over in the office, the deputy warms his hands near the boiler. 

[Your score has just gone up by one point.]

>eat beans
When you were a child, you remember visiting your cousins, who all liked beans. Your aunt insisted that if they could eat beans, so could you. You choked on them, and coughed them up, and they made fun of you. Since then, you don't even like the way they smell. The beans, that is. Actually, your cousins are kind of rank too.

Nonetheless, your stomach is growling and you could do with a meal.

[You have dealt with a repressed childhood memory in a constructive manner, your score just went up by two points]

>eat beans
The beans disgust you even more than the rancid meat.

[The thought is enough to make you lose a point.]

>eat beans
No. It's a matter of principle now.

[Your score just went back up by a point for being so principled.]

>eat beans
Give Muddy the damn beans. He likes them, but they you can't stand to even look at them.

>give can to muddy
Muddy takes the can and stares hungrily at the beans.

Even in the most dire situation, Muddy's appetite remains intact. He looks expectantly at you and says, "Rick, got a spoon?"

In the office, the deputy inspects his LeMat revolver lovingly. 

[Your score has just gone up by two points.]

>give spoon to muddy
Muddy cracks a gap-toothed smile and says, "Much obliged," before digging into the can of beans like a miner hot on a fresh gold vein. A couple moments later, he finishes circling the inside of the can with the spoon, trying to get every last drop of bean juice into his mouth. Afterwards, he places the can and spoon on the floor and rubs his stomach with satisfaction.

Muddy has an aura of well-fed contentment.

* * *

>z
Time passes.

Muddy holds his belly and comments, "Got a bit of indigestion, I does."

>z
Time passes.

Muddy wraps his arms around his belly, and moans softly, "I might have overdone it with them beans."

The deputy looks up from his reading, curious.

>z
Time passes.

Muddy doubles over, "Rick, you should get to high ground. I'm feeling a mite bloated after them beans, and I think you know what's coming!"

"Where the Sam Hill do you think I'm going to run to, Muddy? We're locked up in a hoosegow! Deputy, if'n I was you, I would put some distance between Muddy and your nose.
"

The Deputy looks concerned, but confused.

>z
Time passes.

You hear nothing. The smell nearly knocks you out. Vision fades, the room spins.

Muddy whispers in that understated manner of his, "That were a silent but deadly."

>z
Time passes.

Suppressing the urge to throw up from the smell, the deputy reaches over to the whiskey bottle and half drains it on his way out the door.

The fragrance gradually improves as the universe cools.

>z
Time passes.

"Ain't you gonna ask me about my plan?" Muddy whispers.

>z
Time passes.

"This time mah plan is sure fire -- go ahead, ask me. C'mon." Muddy jibes quietly. 

The deputy pokes his head back in the office and remarks, "I've about had enough of you characters. You can stew in your own juices here. I got important things to do over yonder in the saloon. But I reckon I would be dairy licked to leave you jokers alone."

The deputy grabs a dinner bell from the hook where it hangs next to the office door, and he rings the bell slowly a few times. Nothing happens. He rings it again. Minutes go by, and the deputy waits impatiently. Finally, a fat bloodhound waddles leisurely through the door way, tempted by the dinner bell.

The deputy reaches into his pocket and retrieves a scrap of beef jerky. He pitches it into the dog's bowl and the bloodhound gobbles it down. The deputy leads his mangy old dog towards the office's strange looking steam boiler and ties him to it with a leash.

"This here's Flash, my hunting dog. I got to warn you that he can be vicious when he gets riled up, so don't cross him." Flash slowly slumps down next to the boiler, enjoying the heat. His heavy eyes close and drool drips from his toothless mouth.

"Flash here's apt to rip your throat out if you so much as look at him funny, but I got him hooked up here to the sheriff's fancy steam contraption." The deputy narrows his eyes distrustfully. "If you boys were so stupid as to make for the jailhouse door, 'ol Flash would yank that lever and set off the steam whistle on the roof. The sheriff installed it special for me, so as I can come when he wants me. I can hear that half way across town, and if'n I do hear it, then you'll have to deal with me *and* Flash." The deputy gives Flash one last pat on the head, swigs the whiskey one more time, and departs for the saloon.