As the sun sets on the plains, Sheriff Cheney angrily snaps on the cuffs. You are shoved into the coach and land on top of Muddy Charlie and a pile of  silver dollars, which until recently had been the property of the Missouri, Kansas & Texas Line.

Muddy whispers, "Don't fret none, Rick! You done good blowing up that tunnel -- I just didn't plan on the sheriff getting word ahead of time, is all. That were powerful bad luck."

The sheriff climbs onto his horse, spits, and you begin to rumble forward. "You boys really got it coming this time," he yells back cheerfully.

Muddy shakes his head. "No offense, Sheriff, but I reckon you got the wrong men. We was just on our way to the theater."

The sheriff disagrees. "The only place you boys are heading is straight to the... 

Hoosegow
A Wild West Wreck by Ben Collins-Sussman and Jack Welch
Release 8 / Serial number 100131 / Inform 7 build 5Z71 (I6/v6.31 lib 6/12N) SD
Type "help" for instructions and "hints" for hints -- or just roll into town guns a-blazin'.

[Press Space To Continue]

In the twilight, you sight the sheriff's sturdy brick office near the edge of town. "That's mighty fine construction," notes Muddy, sounding less feisty now. "Mighty fine indeed." The coach rolls to a halt and a thick arm yanks you roughly from your seat. You land awkwardly in the rutted street, where the sheriff holds you in place with the heel of one boot. He yells to his men, "Bring the coach around back, we got to impound that evidence." You are shoved into the sheriff's office and then into a small holding cell.

The deputy wakes with a start, whips his dusty boots off the desk and stands, tucking his shirt back into his pants. The sheriff gives him a brief, judgmental glance and offhandedly tosses an arrest warrant on the desk. He barks, "Jimbo, listen up. Picked up these two down near the train. A federal marshal will be coming for them at eight o'clock tomorrow morning. There's going to be a hanging!" The deputy nods slowly. The sheriff continues, "Please take care of our 'guests'. I got to head down to Wichita Falls to discuss my invention with some investors, so you is in charge." The deputy smiles until the sheriff adds, "Jimbo, don't screw up," as he heads out the door.

Jail Cell
Why are you not surprised to have landed right back in the hoosegow after another one of Muddy's dubious plans? Will you ever learn? How did it come to this? 

The small jail cell is brick on three sides, metal bars on the other, with a tightly locked gate. A small window is set into the brickwork above your head. Through the jail bars you can see the sheriff's office.

A broken stool lies on the floor.

Muddy leans against the wall tapping a harmonica on his arm.

In the corner of the cell, a disheveled man in a black suit is stretched out on a crude wooden bench and is snoring loudly, oblivious to your presence.

>x boots
Black boots that have seen better days. The left boot is missing its heel spur.

On the other side of the jail bars in the office, the deputy peeks through the jail cell window at the saloon across the street. It's clear he'd rather be there.

>remove boot
Which all do you mean, the left boot, or the right boot?

>left
In some states that would be a felony. Are you sure?

(yes or no) >

>yes
You rock back and forth on the floor, locked in a death struggle with your foot. Beads of sweat form on your head, as you struggle to twist and pull the boot off. With a sudden sucking pop, the boot relents and you tumble backwards.

Muddy's eyes water as he complains, "Ain't you got no sense of smell in that head of yours?"

To which you reply, "Not after I been downwind of you around feeding time, nope. This ain't nothing next to what you can do with a can of beans!"

The deputy wrinkles his nose in distaste and produces a fat cigar from his pocket. He reaches over to the office's steam boiler, lights the cigar, walks right up to the jail bars and blows the smoke directly into your face. The stench of the cigar is evenly matched against the reek of your feet.

>smell
The whole place reeks of cheap cigar smoke.

Back in the office, the deputy stares at Muddy.

>remove boot
(the right boot)
Oh, you really don't want to do that. Not indoors at least. Are you sure?

(yes or no) >

>yes
You rock back and forth on the floor, locked in a death struggle with your foot. Beads of sweat form on your head, as you struggle to twist and pull the boot off. With a sudden sucking pop, the boot relents and you tumble backwards.

Muddy's eyes water as he complains, "Not again! My poor nose!"

The Deputy's cigar seems to shrivel and hang limply in his mouth, as its prodigious odor is astronomically outclassed by the combined stench of your two feet. Suppressing the urge to throw up from the smell, the deputy reaches over to the whiskey bottle and half drains it on his way out the door.

After he leaves, you give in to Muddy's desperate pleas to put your boots back on.

The fragrance gradually improves as the universe cools.
[Your score has just gone up by one]

>smell
It stinks to high heaven.

Muddy drums his fingers against the wall.

>z
Time passes.

The deputy pokes his head back in the office and remarks, "I've about had enough of you characters. You can stew in your own juices here. I got important things to do over yonder in the saloon. But I reckon I would be dairy licked to leave you jokers alone."

The deputy grabs a dinner bell from the hook where it hangs next to the office door, and he rings the bell slowly a few times. Nothing happens. He rings it again. Minutes go by and the deputy waits impatiently. Finally, a fat bloodhound waddles leisurely through the door way, tempted by the dinner bell.

The deputy reaches into his pocket and retrieves a scrap of beef jerky. He pitches it into the dog's bowl and the bloodhound gobbles it down. The deputy leads his mangy old dog towards the office's strange looking steam boiler and ties him to it with a leash.

"This here's Flash, my hunting dog. I got to warn you that he can be vicious when he gets riled up, so don't cross him." Flash slowly slumps down next to the boiler, enjoying the heat. His heavy eyes close and drool drips from his toothless mouth.

"Flash here's apt to rip your throat out if you so much as look at him funny, but I got him hooked up here to the sheriff's fancy steam contraption." The deputy narrows his eyes distrustfully. "If you boys were so stupid as to make for the jailhouse door, 'ol Flash would yank that lever and set off the steam whistle on the roof. The sheriff installed it special for me, so as I can come when he wants me. I can hear that half way across town, and if'n I do hear it, then you'll have to deal with me *and* Flash." The deputy gives Flash one last pat on the head, swigs the whiskey one more time, and departs for the saloon.

* * *

>take harmonica
"I ain't never seen you play the mouth organ, Muddy."

Your partner turns the harmonica back and forth, and a chain rattles. "That's 'cuz I ain't never learned how," he replies.

Muddy hands the harmonica to you.

>play harmonica
You tentatively blow on it a bit, but you're not rightly sure what you're doing.

The deputy grimaces, "Knock off that racket, you two. A noise like that, a man can't get to thinking straight. Settle down now, you hear? I got me some reading to do." The deputy unfolds the warrant, furrows his brow and begins reading. You can tell because his lips are moving. Slowly.

On the other side of the jail bars in the office, the deputy watches you with a bored expression.

>play harmonica
The deputy cringes, as you blow not only the notes that are built into the harmonica, but every note in between as well. He stands up, shoves the warrant into his pocket, and grabs a bottle of whiskey off the cabinet.

"I declare: that's just the worst thing I ever heard in my life. It's enough to drive a man to drink." To prove it, he takes a mighty swig from the whiskey bottle and wipes his mouth with the back of his sleeve. The deputy puts his fingers in his ears and tries to ignore you.

You keep playing.

The deputy balls his hands into fists and trembles with annoyance, "I'm going to the saloon to listen to some real music, from some real talented lady folk of the female persuasion." The deputy walks out the front door in a huff.

"You should hear me play piano," you remark, but he's already out of earshot.

[Your score has just gone up by one]

Muddy says, "Nice one.  Hey -- I reckon I saw that screw up there wiggle a bit when you played the harmonica. I didn't say nothing on account what the deputy was here."  He points to a screw holding in one of the cell bars.

A fly buzzes past your ear and lands on the ceiling.

>z
Time passes.

The deputy pokes his head back in the office and remarks, "I've about had enough of you characters. You can stew in your own juices here. I got important things to do over yonder in the saloon. But I reckon I would be dairy licked to leave you jokers alone."

The deputy grabs a dinner bell from the hook where it hangs next to the office door, and he rings the bell slowly a few times. Nothing happens. He rings it again. Minutes go by and the deputy waits impatiently. Finally, a fat bloodhound waddles leisurely through the door way, tempted by the dinner bell.

The deputy reaches into his pocket and retrieves a scrap of beef jerky. He pitches it into the dog's bowl and the bloodhound gobbles it down. The deputy leads his mangy old dog towards the office's strange looking steam boiler and ties him to it with a leash.

"This here's Flash, my hunting dog. I got to warn you that he can be vicious when he gets riled up, so don't cross him." Flash slowly slumps down next to the boiler, enjoying the heat. His heavy eyes close and drool drips from his toothless mouth.

"Flash here's apt to rip your throat out if you so much as look at him funny, but I got him hooked up here to the sheriff's fancy steam contraption." The deputy narrows his eyes distrustfully. "If you boys were so stupid as to make for the jailhouse door, 'ol Flash would yank that lever and set off the steam whistle on the roof. The sheriff installed it special for me, so as I can come when he wants me. I can hear that half way across town, and if'n I do hear it, then you'll have to deal with me *and* Flash." The deputy gives Flash one last pat on the head, swigs the whiskey one more time, and departs for the saloon.

* * *

>play harmonica
You tentatively blow on it a bit, but you're not rightly sure what you're doing.

The deputy grimaces, "Knock off that racket, you two. A noise like that, a man can't get to thinking straight. Settle down now, you hear? I got me some reading to do." The deputy unfolds the warrant, furrows his brow and begins reading. You can tell because his lips are moving. Slowly.

On the other side of the jail bars in the office, the deputy watches you with a bored expression.

>hit bars
Muddy stands back as you let loose with your full fury and pound on the metal bars.
As you beat them senseless, you notice that one of them sounds hollow. But which was it?

The deputy looks up from the warrant, annoyed at the distraction. "Them jail bars is solid iron, boys. Now stop messing with them. I would surely hate to have to shoot you tonight and ruin tomorrow's hanging."

>hit rods
The deputy shifts forward in his seat, "I done told you once, don't mess with the metal bars, not the jail bars, and not them rods in the window. It ain't like it's going to help you none anyhow, but it don't seem proper, what with me sitting here. Keep it up, and I may have to shoot some lead in your direction. That's a metaphor. It means, I'm going to have to shoot you, in case you don't know what a metaphor is. See. Lead is what's in bullets, so in this case, lead is a symbol for... um, lead. I can see I'm wasting my time explaining this to the likes of you."

>scream
That ain't no verb I got knowledge of.

>sing
You got a right fine voice. Just not for singing.

>dance
That ain't no verb I got knowledge of.

>hit bars
Muddy stands back as you let loose with your full fury and pound on the metal bars.
As you beat them senseless, you notice that one of them sounds hollow. But which was it?

The deputy rubs his head with his palms and growls, "I'm a-warning you first instead of a-shooting you first because I got myself a bad headache and I don't need the extra noise. Keep messing with them jail bars and I will scratch my itchy trigger finger."

Muddy raises his eyebrows at you to get your attention and whispers, "He ain't kidding, Rick. We best not push him too far. He's  a rattlesnake in a bottle of tequila."

"What the blazes does that mean, Muddy?"

"Just metanymy, I reckon."

>hit bars
Muddy stands back as you let loose with your full fury and pound on the metal bars.
As you beat them senseless, you notice that one of them sounds hollow. But which was it?

Without bothering to get up from his comfortable position behind the desk, the deputy draws his mean-looking nine-shot LeMat revolver and squeezes off a lazy shot in your direction, only looking afterwards to see if he hit anything. "I said, stop messing around in there, or the vultures are going to dine early tonight."

>hit bars
Muddy stands back as you let loose with your full fury and pound on the metal bars.
As you beat them senseless, you notice that one of them sounds hollow. But which was it?

The deputy folds down his paper and leers at you, "Don't tempt me. I could do with some target practice."

Muddy shakes his head, motioning you back. "Rick, this guy's one stagecoach stop short of the fort, if you know what I mean. We best to find a way to get him out of the picture, or we ain't never going to get out of here."

>hit bars
Muddy stands back as you let loose with your full fury and pound on the metal bars.
As you beat them senseless, you notice that one of them sounds hollow. But which was it?

The deputy rolls his eyes, "You is about the dumbest, stupidist, most corn-starched spit-lickingest idiotic pie-brained goat-galooting criminals I did ever see."

He pulls his gun out from under the desk and uses it for punctuation, mainly of the ceiling. "Listen, you!" (Bang.) "When I said--" (bang) "--don't--" (bang) "--go messing--" (bang) "--with stuff--" (bang) "--I meant it." (Bang, bang.) "Now, do you understand me-- " (bang). The last bang rises slightly in pitch to convey that it was a question.

The bullets ricocheting off the jailhouse walls every which way are enough to shake up even Muddy, who hisses, "Stop messing with him Rick, the clock's ticking and we got to get out here by morning, or we'll be wearing hemp neckties for the rest of our lives. Rick, you got to figure us a way to get him out of here, so we can get busy with some proper jail-breaking."

>hit bars
Muddy stands back as you let loose with your full fury and pound on the metal bars.
As you beat them senseless, you notice that one of them sounds hollow. But which was it?

The deputy leaps up, this time angry, his face flushing. He stuffs the paper in his pocket and levels his gun at your head. "I had enough of you! (click)" He stares stupidly at his gun before realizing that he has to reload it. "Lucky for you, I reckon." He begins plucking bullets from his belt and loading them one by one into the cylinder. "You so much as sing, and I'll have to see to your killing."

A look of fear washes over Muddy's face, "Don't do it, Rick. Don't do it."

>sing
The deputy sighs, raises his gun and fires. You catch the bullet smack dab in forehead.

As the lights fade, Muddy bends over you and closes your eyes, whispering, "I ain't gonna give you up, I ain't gonna let you down..."

*** YOU'VE BEEN ROLLED, RICK ***

Would you like to RESTART, RESTORE a saved game, or QUIT?

* * *

>x bench
A long wooden bench made of rough, splintery planks. Under the bench, you notice a piece of questionable meat, a spoon and a metallic can.

On the other side of the jail bars in the office, the deputy repeatedly counts his fingers, but is unable to get a firm answer.

>x meat
The deputy has been watching you and he smiles sardonically. "I see you found your dinner. Or was that last week's dinner? Har, har!"

You are distracted by his comment and forget what you were doing.

>take can
Fetched.

Back in the office, the deputy peeks through the jail cell window at the saloon across the street. It's clear he'd rather be there.

>take spoon
Fetched.

>x can
A closed metal can labeled "BEANS". On the back, some fine print says, "Precooked beans. No claim is made regarding the cardioprotective nature of this product. May cause abdominal distension if ingested. No fitness of purpose is implied. No warranty is provided for personal or other injury, or injury or loss related directly or indirectly to the use of this product. By opening this can, you agree to the terms of service posted in town."

>x boots
Black boots that have seen better days. The left boot is missing its heel spur.

Muddy paces back and forth impatiently.

>x right boot
A cowhide boot that has been rubbed smooth. A metal riding spur is about ready to fall off the worn-down heel.

Just to the side of the desk, the boiler creaks.

>take spur
You yank the spurs off your right boot, careful not to cut yourself in the process.

On the other side of the jail bars in the office, the deputy stares at Muddy.

>open can with spur
Muddy cranes his neck to see what you're doing. He's never seen someone open a can with heel spurs. You slide the spur into the groove along the top of the can, and wiggle it back and forth. The can revolves, and the lid is nearly sawn off. It is hard to tell which of you is more surprised that this worked. 

[Your score has just gone up by five]

Over in the office, the deputy runs his hand through his sparse hair.

>eat beans
When you were a child, you remember visiting your cousins, who all liked beans. Your aunt insisted that if they could eat beans, so could you. You choked on them, and coughed them up, and they made fun of you. Since then, you don't even like the way they smell. The beans, that is. Actually, your cousins are kind of rank too.

Nonetheless, your stomach is growling and you could do with a meal.

[You have dealt with a repressed childhood memory in a constructive manner, your score just went up by two points]

On the other side of the jail bars in the office, the deputy watches you with a bored expression.

>eat beans
The beans disgust you even more than the rancid meat.

[The thought is enough to make you lose a point.]

>eat beans
No. It's a matter of principle now.

[Your score just went back up by a point for being so principled.]

Over in the office, the deputy warms his hands near the boiler.

>eat beans
Give Muddy the damn beans. He likes them, but you can't stand to even look at them.

>give beans to muddy
Muddy takes the can and stares hungrily at the beans.

Even in the most dire situation, Muddy's appetite remains intact. He looks expectantly at you and says, "Rick, got a spoon?"

Halfway between the door to the outside and your jail cell, the furnace puffs some steam into the office.

>give spoon to muddy
Muddy cracks a gap-toothed smile and says, "Much obliged," before digging into the can of beans like a miner hot on a fresh gold vein. A couple moments later, he finishes circling the inside of the can with the spoon, trying to get every last drop of bean juice into his mouth. Afterwards, he places the can and spoon on the floor and rubs his stomach with satisfaction.

Muddy has an aura of well-fed contentment.

* * *

>z
Time passes.

Muddy wraps his arms around his belly, and moans softly, "I might have overdone it with them beans."

The deputy looks up from his reading, curious. 

"Ain't you gonna ask me about my plan?" Muddy whispers.

>z
Time passes.

Muddy doubles over, "Rick, you should get to high ground. I'm feeling a mite bloated after them beans, and I think you know what's coming!"

"Where the Sam Hill do you think I'm going to run to, Muddy? We're locked up in a hoosegow! Deputy, if'n I was you, I would put some distance between Muddy and your nose. "

The Deputy looks concerned, but confused. 

"This time my plan is surefire -- go ahead, ask me. C'mon." Muddy jibes quietly.

>z
Time passes.

You hear nothing. The smell nearly knocks you out. Vision fades, the room spins.

Muddy whispers in that understated manner of his, "That were a silent but deadly."

"Ain't you even a speck curious to ask me about my plan?" taunts Muddy.

>z
Time passes.

Suppressing the urge to throw up from the smell, the deputy reaches over to the whiskey bottle and half drains it on his way out the door.

The fragrance gradually improves as the universe cools.
[Your score has just gone up by one]

"Truthful, Rick," whispers Muddy solemnly, "this ain't like all my other plans, this one is iron-clad. Ask me about it. Go ahead."

>z
Time passes.

Muddy vibrates with excitement and gushes, "I got to tell you, Rick, or this new plan of mine is going to drive me plumb crazy!" 

"Let's keep this between us, though", he whispers.

He notices the sleeping man in your cell for the first time. "Don't know about him." Muddy jerks his thumb towards the sleeping figure. "Might be a spy."

Muddy leans towards you, his face barely an inch from your ear and his buzzard-worthy breath even less so from your nose. "Okay, Rick, I'm a-going to tell you my plan." Muddy pauses dramatically. "Here it is: we got to break out of this jail before we get strunged up."

"That's it? That's your whole damn plan? That don't count as no plan!" you fume.

"Keep it down, Rick!" Muddy's gaze darts over to your third cellmate. "Yeah, that's it for now. It takes time to cook up a good plan. You need lots of ingredients."

"Muddy Charlie," you retort, "I heared you was the worst cook in the Confederate Army. Your cooking like as did more damage than Sherman's March."

Muddy gives you a hurt look and sulks in the corner. After a while, you regret being so quick-tempered with your old buddy.

>z
Time passes.

The deputy pokes his head back in the office and remarks, "I've about had enough of you characters. You can stew in your own juices here. I got important things to do over yonder in the saloon. But I reckon I would be dairy licked to leave you jokers alone."

The deputy grabs a dinner bell from the hook where it hangs next to the office door, and he rings the bell slowly a few times. Nothing happens. He rings it again. Minutes go by and the deputy waits impatiently. Finally, a fat bloodhound waddles leisurely through the doorway, tempted by the dinner bell.

The deputy reaches into his pocket and retrieves a scrap of beef jerky. He pitches it into the dog's bowl, and the bloodhound gobbles it down. The deputy leads his mangy old dog towards the office's strange-looking steam boiler and ties him to it with a leash.

"This here's Flash, my hunting dog. I got to warn you that he can be vicious when he gets riled up, so don't cross him." Flash slowly slumps down next to the boiler, enjoying the heat. His heavy eyes close, and drool drips from his toothless mouth.

"Flash here's apt to rip your throat out if you so much as look at him funny, but I got him hooked up here to the sheriff's fancy steam contraption." The deputy narrows his eyes distrustfully. "If you boys were so stupid as to make for the jailhouse door, 'ol Flash would yank that lever and set off the steam whistle on the roof. The sheriff installed it special for me, so as I can come when he wants me. I can hear that halfway across town, and if'n I do hear it, then you'll have to deal with me *and* Flash." The deputy gives Flash one last pat on the head, swigs the whiskey one more time, and departs for the saloon.

>x man
The man crumpled in the corner wears a black suit and a pastor's neck tie. He'd almost look respectable, if it weren't for the immediate environment. He reeks of booze and snores loudly. A pamphlet is sticking out of his pocket. You don't consider yourself a common pickpocket, but it makes you wonder what else he might have on him.

Flash nuzzles up to the boiler.

"That worked out well," says Muddy proudly.

"For you maybe," you reply. "But I near as lost my lunch what with that stench."

To which Muddy counters, "Ain't much worse than your feet, I reckon."

>take pamphlet
You carefully slip the pamphlet out of the sleeping man's pocket.  He almost wakes up, but doesn't.

"Whatizit?", Muddy rasps.

Flash snores loudly, his jowls fluttering with each breath.

>x pamphlet
The pamphlet depicts God in a cowboy hat roasting sinners over a camp fire. A sermon is printed below the picture.

>read pamphlet
You read it aloud:

"The Prairie Gospel Church of Uncanny Righteousness"

"For lo, the impetuous and retributive spirit of FINAL JUDGEMENT is stirring in the heart of the unfaithful, and a FIERY thunderhead of retribution is gathering across the plains of the undeserving, the bereft of propriety, and promulgators of heresy, and the scalding hot sparks of TRUTH are spraying forth, catching light the arid and HIGHLY FLAMMABLE and veritably kerosene-soaked sawdust of the weak-willed. And into this fray, the unwholesome BEAST shall arise and the earth shall tremble. Its body shall tower above like a mountain, and upon the body shall be nineteen heads, each like unto a serpent. Upon each head, twelve horns, like that of the ram, the bull, and the elephant, say four of each. And upon each horn, sixteen stalks, not unlike celery in some respects, yet more flexible, more like the arms of an octopus, except being twice as numerous. And upon each stalk, eighty eyes, or forty pairs of eyes, if you prefer!"

Muddy, who had been staring intently at his boot tips, looks up, eye brows knit in concentration. "I don't get it. Why would anything need two hundred ninety-one thousand, eight hundred and forty eyes?"

"What?" you remark, looking up from the pamphlet. "Are you kidding me? How could you figure that out?"

"Don't rightly know. Just something I do. Same way as I know there's 69,105 railroad ties between here and Muskogee. Ma said I was some kind of idiot savage."

Dumbfounded, you stop reading halfway through the pamphlet to stare incredulously at Muddy, who picks his nose. "Yeah, go on. What else's it say?"

>read pamphlet
You straighten out the pamphlet and skim it, paraphrasing for Muddy.

"Well let's see. It keeps going on like that for a ways without really saying much. By and by there's this part about a revival meeting. Some kind of doxology works, but out in the open, like under a circus tent. It says they'll be some preaching, some healing and even some dancing. I'd allow it sounds like a right pleasant shindig, it do."

Muddy pauses. "Can I see that pamphlet a minute?" asks Muddy

Flash swallows loudly.

>give pamphlet to muddy
Muddy grabs it from you, squinting and sounding out words silently with his mouth. His eyes open wide in amazement.

"Pete? Wait a gosh darn... PASTOR Pete? That really him? Hot diggity!"

Muddy jumps to his feet, runs to the bench and shakes Pete wildly; Pete screams and throws his hands into the air, gesticulating to heaven as he's awoken from his dream --

"BEGONE, devils! God shall SMITE thee! He who brushes the Lord's horses shall not clean the stables of HEAVEN!"

The grubby preacher collapses back on the bench, eyes closed and snoring before either of you can take a step.

>search pete
You find a tin of chewing tobacco. It looks interesting, so you borrow it.

Muddy drums his fingers against the wall.

>i
You're carrying a tin, a pamphlet, a spur, your pocketwatch, and a scrap of paper. You are wearing your hat, pants, overcoat, left boot, and right boot. 

Your revolver was confiscated, it seems.

>open tin
You open the tin, revealing a wad of tobacco.

Pastor Pete jumps straight up, immediately animate. He screams, "What a wok is SPAM! Hot, nubile raisins, how if it is not feckless tea? INFORM and mooing hot espresso at a mere apple? INACTION cowlick angles? Incomprehension, how'd you like a cod? The bow tie unfurled, the parabola ova nibbles; and yacht to my wad isthmus queen tennis off dost? MY CANDLE LIGHTS ME NOT, Norway man knees air; throw by your Somali lint use, eat meat, seize Sue!

Pete collapses onto the bench and resumes his previous position as if nothing had happened.

>read tin
A rectangular tin of "Spitting Image" chewing tobacco. The cover shows a cowboy painting a portrait of an Indian, and true to its name, the image on the canvas looks just like the Indian. The tin is opened revealing some shredded black chewing tobacco.

Flash almost moves, but then doesn't.

>x tin
A rectangular tin of "Spitting Image" chewing tobacco. The cover shows a cowboy painting a portrait of an Indian, and true to its name, the image on the canvas looks just like the Indian. The tin is opened revealing some shredded black chewing tobacco.

Muddy cracks his knuckles loudly.

>chew tobacco
(first sticking some in your maw)
The tobacco is getting juicy and soft.

>chew tobacco
It tastes pretty horrid.

Pastor Pete shakes and twists spasmodically.

>chew tobacco
You wonder if tobacco is really good for you, like the doctors say.

Muddy closes his eyes and rubs his temples.

>chew tobacco
The taste of the tobacco is beginning to disgust you. You'd like to get it out of your mouth.

It feels cooler than it did last night.

>spit tobacco at bell
Ding! The bell is hit so hard that it spins around on the hook several times, clanging like a church bell on Sunday.

The ameoba-like mass of fat and fur known to you as Flash leaps immediately to his feet, saliva dripping from his toothless jowls. He lunges like a champion fencer for his food bowl. His leash snaps taut, pulling the lever away from the front door and towards the strange machine.

The boiler hisses and gurgles, steam jets from the rivet joints in the pipe that connects to the machine, and the machine itself vibrates and rumbles for a minute. A white cup drops from a chute and brown liquid squirts from a nozzle and fills the cup. The smell of fresh coffee pervades the office.

Finding no food in his bowl, Flash huffs perfunctorily and resumes his former position, pulling the lever back to the middle position.
[Your score has just gone up by one]

Muddy stares out the window.

* * *

>ask muddy about plan
"I already done told you -- we got to bust out."

"That worked out well," says Muddy proudly.

"For you maybe," you reply. "But I near as lost my lunch what with that stench."

To which Muddy counters, "Ain't much worse than your feet, I reckon."

>take harmonica
"I ain't never seen you play the mouth organ, Muddy."

Your partner turns the harmonica back and forth. "That's 'cuz I ain't never learned how," he replies.

Muddy hands the harmonica to you.

>play harmonica
Tentatively, you blow a few notes. The bars in the jail cell rattle sympathetically.

"Look at that, boy", Muddy laughs, "I swear that screw up there holding that bar is wiggling loose!"

>play harmonica
Again, the room resonates with the rich and vibrant tones of a bagpipe connected to the blowhole of a beluga whale.

Muddy points excitedly towards the top of the gray bar, "When you played, that screw worked its way out more. It's like you got some kind of sonic screwdriver or something! I think one more time will do it."

>play harmonica
The screw vibrates out of the ceiling, rebounds off the concrete floor in a shower of sparks, and rolls under the deputy's desk. A hollow gray tube falls loose from the upper reaches of the jailbars and lands at your feet.

"You done it!" shouts Muddy.

>take bar
(the gray tube)
You grab the bar.

You hold it lengthwise and stare down its hollow shaft at Muddy. He looks back at you. 

"Don't that just beat all," ponders Muddy.
[Your score has just gone up by one]

>put bar in socket
(the gray tube in the socket)
You flip the stool over and wiggle the hollow gray tube into the empty socket. It fits perfectly and remains in place when you let go of the bar, but you think you could yank the gray bar out again if you needed it. You now have a stool with three even legs: two wood, one metal.

>stand on stool
Muddy holds it steady as you climb up. Your head is now even with the top of the window.

>look out window
The jail is at the end of a long street. Directly across the street is a saloon, which is open, unlike the stores on both sides of the street that have pulled down their shades for the evening. Below the window there is a covered barrel; you can almost touch its top. Just to the left of the window, a berry-covered vine has grown up the side of the building. 

Up in the sky, you notice a couple of hungry, circling vultures.

>x vine
Only the leafless tip of a wiry vine pokes into the cell through the window. It's covered with small red berries.

>take berry
You pluck a plump juicy red berry from the part of the vine growing outside the window.
[Your score has just gone up by one]

>get down
You jump down to the ground again.

Jail Cell
The small jail cell is brick on three sides, metal bars on the other, with a tightly locked gate. A small window is set into the brickwork above your head. Through the jail bars you can see the sheriff's office.

A repaired stool stands upright.

Muddy leans against the wall.

In the corner of the cell, a disheveled man in a black suit is stretched out on a crude wooden bench and is snoring loudly, oblivious to your presence.

You can also see a can of beans (in which is a spoon) and a hunk of meat here.

A dented food bowl sits on the office floor, only a few feet from the jail bars.

In the office you can also see Flash.

>take gray bar
You yank the bar out of the stool's socket.

>put berry in bar
(the gray tube)
You drop the berry into the gray tube.

"Oh, I get it!" nods Muddy, "You're making some kind of berry gun. I seen the Injuns do something like that, except you ain't got no darts in there to blow at people."

>blow berry at bell
Ding! The bell is hit so hard that it spins around on the hook several times, clanging like a church bell on Sunday.

The amoeba-like mass of fat and fur known to you as Flash leaps immediately to his feet, saliva dripping from his toothless jowls. He lunges like a champion fencer for his food bowl. His leash snaps taut, pulling the lever away from the front door and towards the strange machine.

The boiler hisses and gurgles, steam jets from the rivet joints in the pipe that connects to the machine, and the machine itself vibrates and rumbles for a minute. A white cup drops from a chute and brown liquid squirts from a nozzle and fills the cup. The smell of fresh coffee pervades the office.

Finding no food in his bowl, Flash snorts perfunctorily and resumes his former position, pulling the lever back to the middle position.
[Your score has just gone up by one]

>put gray bar in socket
You flip the stool over and wiggle the hollow gray tube into the empty socket. It fits perfectly and remains in place when you let go of the bar, but you think you could yank the gray bar out again if you needed it. You now have a stool with three even legs: two wood, one metal.

>climb stool
Muddy holds it steady as you climb up. Your head is now even with the top of the window.

>take berry
You pluck a plump juicy red berry from the part of the vine growing outside the window.

>eat berry
Muddy stops you, "Don't be a coward -- if'n you eat that, you'll sleep clear through to the afternoon -- and we only got till eight in the "A" of "M" to get out of here."

>eat berry
Eight in the morning comes faster than you expected, and the sheriff and marshal show up punctually. You, Muddy and Pete are loaded into a wagon and escorted to Fort Sill. The three of you are marched up the gallows, and ropes are tightened around your necks.

From the other side of the preacher, Muddy yells over to you, "Rick...Rick...."

You ignore him. You're just not in the mood.

Muddy persists. "Rick... Rick...."

"What?" you huff. "I hope this ain't another of your plans. It would be a little late."

"Nope, no plan Rick. I just wanted to mention that from up here, I can see our house."

The floor falls away, and everything goes dark.

*** HANGED ***

Would you like to RESTART, RESTORE a saved game, or QUIT?

* * *

>take berry
You pluck a plump juicy red berry from the part of the vine growing outside the window.

>get down
You jump down to the ground again.

Jail Cell
The small jail cell is brick on three sides, metal bars on the other, with a tightly locked gate. A small window is set into the brickwork above your head. Through the jail bars you can see the sheriff's office.

A repaired stool stands upright.

Muddy leans against the wall.

In the corner of the cell, a disheveled man in a black suit is stretched out on a crude wooden bench and is snoring loudly, oblivious to your presence.

You can also see a can of beans (in which is a spoon) and a hunk of meat here.

A dented food bowl sits on the office floor, only a few feet from the jail bars.

On the machine is a cup (in which is some coffee).

In the office you can also see Flash.

>take gray bar
You yank the bar out of the stool's socket.

>put berry in bar
(the gray tube)
You drop the berry into the gray tube.

>blow berry at coffee
The berry splatters against the side of the cup, and its juice dribbles downwards.

Muddy jumps up, claps you congratulatorily on the back, and you nearly swallow the metal tube still held to your lips.

He beams, "That were a one in a million shot, Rick!"  Muddy strokes his chin and wags a finger at the cup, "Now, if we can only get the deputy to come back and drink some coffee, he might be a whole lot more cooperative, I reckon."

You sure like the way Muddy thinks.
[Your score has just gone up by one]

>take off left shoe
You ain't able to see no such thing.

>take off left boot
In some states that would be a felony. Are you sure?

(yes or no) >

>yes
You rock back and forth on the floor, locked in a death struggle with your foot. Beads of sweat form on your head, as you struggle to twist and pull the boot off. With a sudden sucking pop, the boot relents and you tumble backwards.

Muddy's eyes water as he complains, "Ain't you got no sense of smell in that head of yours?"

To which you reply, "Not after I been downwind of you around feeding time, nope. This ain't nothing next to what you can do with a can of beans!"

Flash wakes with a start and sneezes loudly. The fur on his back bristles and he opens his eyes to stare in horror at your feet. He backs away, towards the front door. The leash pulls taut. He seems caught in the balance between an urge to run away from your stinky foot and his own laziness which holds him to the spot.

* * *

>take off right boot
There are people within a thousand yards. Are you sure?

(yes or no) >

>yes
You rock back and forth on the floor, locked in a death struggle with your foot. Beads of sweat form on your head, as you struggle to twist and pull the boot off. With a sudden sucking pop, the boot relents and you tumble backwards.

Muddy's eyes water as he complains, "Not again! My poor nose!"

One foot was bad enough, but two is more than the old dog can handle. Trying not to sniff the air, Flash turns tail and breaks for the door, straining against his leash which is tied to the steam pipe lever. The lever swings towards the door, and from the roof you hear the ear-splitting drone of a railway steam whistle.

You agree with with Muddy that the deputy is not likely to be in a good mood when he arrives, so you put your boots back on.

>z
Time passes.

The Deputy slams through the swinging doors to the office, lurching to the side as he struggles to put his other leg into his pants. He is bare-chested and empty-handed, aside from a nearly empty bottle of whiskey. Flash is so scared that yanks the leash and snaps the lever clear off the machine.

The deputy thunders, "What the hoot-hollering blazes is the matter here?" The deputy surveys the office quickly and then rattles the gate to make sure it is still locked. In his drunk rage, he doesn't notice the missing metal bar. 

"Dumb dog," he mumbles, "I was doing important business." He looks around for Flash, but the dog has already slid out of the office. The deputy waves his fist at you and turns to leave the office.

The deputy brightens. "Ummm. I do smell me some coffee." The deputy drains the mug with a single gulp. "That's good. I got to wake me up some."

Almost immediately, the deputy spins on his heel and drops to the floor just in front of your jail cell.
[Your score has just gone up by one]

>x deputy
You are relieved to find that the deputy is unconscious, but breathing. He is wearing only a pair of pants -- no shirt, no gun belt, no boots.

* * *

>put berry in bar
(the gray tube)
You drop the berry into the gray tube.

>take off left boot
In some states that would be a felony. Are you sure?

(yes or no) >

>yes
You rock back and forth on the floor, locked in a death struggle with your foot. Beads of sweat form on your head, as you struggle to twist and pull the boot off. With a sudden sucking pop, the boot relents and you tumble backwards.

Muddy's eyes water as he complains, "Ain't you got no sense of smell in that head of yours?"

To which you reply, "Not after I been downwind of you around feeding time, nope. This ain't nothing next to what you can do with a can of beans!"

Flash wakes with a start and sneezes loudly. The fur on his back bristles, and he opens his eyes to stare in horror at your feet. He backs away, towards the front door. The leash pulls taut. He seems caught in the balance between an urge to run away from your stinky foot and his own laziness, which holds him to the spot.

>take off right boot
Oh, you really don't want to do that. Not indoors at least. Are you sure?

(yes or no) >

>yes
You rock back and forth on the floor, locked in a death struggle with your foot. Beads of sweat form on your head, as you struggle to twist and pull the boot off. With a sudden sucking pop, the boot relents and you tumble backwards.

Muddy's eyes water as he complains, "Not again! My poor nose!"

One foot was bad enough, but two is more than the old dog can handle. Trying not to sniff the air, Flash turns tail and breaks for the door, straining against his leash, which is tied to the steam pipe lever. The lever swings towards the door, and from the roof you hear the ear-splitting drone of a railway steam whistle.

You agree with with Muddy that the deputy is not likely to be in a good mood when he arrives, so you put your boots back on.

>z
Time passes.

The Deputy slams through the swinging doors to the office, lurching to the side as he struggles to put his other leg into his pants. He is bare-chested and empty-handed, aside from a nearly empty bottle of whiskey.

The deputy thunders, "What the saddle sore slapping blazes is the matter here?" The deputy surveys the office quickly and then rattles the gate to make sure it is still locked. In his drunken rage, he doesn't notice the missing metal bar. 

Satisfied that you haven't escaped, he pushes the lever back to the middle position and warns, "I don't know what you were up to what made old Flash trigger-happy, but don't let it happen again."

"Dumb dog," he mumbles, "I was doing important business." The deputy shakes his head in frustration and sets off again towards the door.

The deputy brightens. "Ummm. I do smell me some coffee." The deputy drains the mug with a single gulp. "That's good. I got to wake me up some."

The deputy looks at the two of you.  "Enough is enough.  You jokers stay put, I'll be back again in a bit."

Flash slinks back to his spot near the boiler and lays down again.

>blow berry at bell
Your projectile ricochets off the bell with a metallic "ding!"

Flash reflexively jumps towards his feeding bowl, pulling the lever and somehow causing the machine to rattle and buzz. Finding no food, the despondent dog returns to his favorite place in front of the boiler, shutting off the coffee machine.

>x cup
A white porcelain mug containing hot coffee.

>put gray bar in socket
You flip the stool over and wiggle the hollow gray tube into the empty socket. It fits perfectly and remains in place when you let go of the bar, but you think you could yank the gray bar out again if you needed it. You now have a stool with three even legs: two wood, one metal.

* * *

>blow berry at coffee
The berry splatters against the side of the cup, and its juice dribbles downwards.

Muddy jumps up, claps you congratulatorily on the back, and you nearly swallow the metal tube still held to your lips.

He beams, "That were a one in a million shot, Rick!"  Muddy strokes his chin and wags a finger at the cup, "Now, if we can only get the deputy to come back and drink some coffee, he might be a whole lot more cooperative, I reckon."

You sure like the way Muddy thinks.
[Your score has just gone up by one]

>remove left boot
In some states that would be a felony. Are you sure?

(yes or no) >

>yes
You rock back and forth on the floor, locked in a death struggle with your foot. Beads of sweat form on your head, as you struggle to twist and pull the boot off. With a sudden sucking pop, the boot relents and you tumble backwards.

Muddy's eyes water as he complains, "Man, them feets of yours stinks powerful bad!"

Flash wakes with a start and sneezes loudly. The fur on his back bristles, and he opens his eyes to stare in horror at your feet. He backs away, towards the front door. The leash pulls taut. He seems caught in the balance between an urge to run away from your stinky foot and his own laziness, which holds him to the spot.

>remove right boot
Oh, you really don't want to do that. Not indoors at least. Are you sure?

(yes or no) >

>yes
You rock back and forth on the floor, locked in a death struggle with your foot. Beads of sweat form on your head, as you struggle to twist and pull the boot off. With a sudden sucking pop, the boot relents and you tumble backwards.

Muddy's eyes water as he complains, "Man, them feets of yours stinks powerful bad!"

One foot was bad enough, but two is more than the old dog can handle. Trying not to sniff the air, Flash turns tail and breaks for the door, straining against his leash, which is tied to the steam pipe lever. The lever swings towards the door, and from the roof you hear the ear-splitting drone of a railway steam whistle.

You agree with with Muddy that the deputy is not likely to be in a good mood when he arrives, so you put your boots back on.

>z
Time passes.

The Deputy slams through the swinging doors to the office, lurching to the side as he struggles to put his other leg into his pants. He is bare-chested and empty-handed, aside from a nearly empty bottle of whiskey. Flash is so scared that he yanks the leash and snaps the lever clear off the machine.

The deputy thunders, "What the hoot-hollering blazes is the matter here?" The deputy surveys the office quickly and then rattles the gate to make sure it is still locked. In his drunken rage, he doesn't notice the missing metal bar. 

"Dumb dog," he mumbles, "I was doing important business." He looks around for Flash, but the dog has already slid out of the office. The deputy checks the gate again and sets off again towards the door.

The deputy brightens. "Ummm. I do smell me some coffee." The deputy drains the mug with a single gulp. "That's good. I got to wake me up some."

Almost immediately, the deputy spins on his heel and drops to the floor just in front of your jail cell.
[Your score has just gone up by one]

>put gray bar in socket
You flip the stool over and wiggle the hollow gray tube into the empty socket. It fits perfectly and remains in place when you let go of the bar, but you think you could yank the gray bar out again if you needed it. You now have a stool with three even legs: two wood, one metal.

* * *

>climb stool
Muddy holds it steady as you climb up. Your head is now even with the top of the window.

>put meat on barrel
The hunk of meat drops on top of the covered barrel that is just beneath the window. Almost immediately, a vulture drops from the sky, lands on the barrel, and begins tearing into the rancid meat.

>x vulture
A scrawny black bird, with a bald head, sharp yellow beak and white-tipped tail feathers. Its head is buried in the putrifying piece of meat on the barrel, and its tail waves provocatively in your face, just below the window.

>x tail
The vulture's tail plumage consists of several long, black feathers with white stripes.

>take feather
You pluck a feather from the vulture's tail. The bird twists its head momentarily to glare at you before plunging back into its task of devouring the rotting meat.
[Your score has just gone up by one]

>take berry
You pluck a plump juicy red berry from the part of the vine growing outside the window.

>get down
You jump down to the ground again.

Jail Cell
The small jail cell is brick on three sides, metal bars on the other, with a tightly locked gate. A small window is set into the brickwork above your head. Through the jail bars you can see the sheriff's office.

A repaired stool stands upright.

Muddy leans against the wall.

In the corner of the cell, a disheveled man in a black suit is stretched out on a crude wooden bench and is snoring loudly, oblivious to your presence.

You can also see a can of beans (in which is a spoon) here.

A dented food bowl sits on the office floor, only a few feet from the jail bars.

In the office you can also see the deputy.

>search deputy
You rifle through his trouser pockets and find a federal warrant. You also find a small brass key. Naturally, you take both.

>open gate with key
(the gate with the small brass key)
That doesn't seem to fit the lock.

>x warrant
A piece of paper with black printing and red handwriting.

>read warrant
"Muddy, this here's a federal warrant!"

"What's it say, Rick?"

I'm a-reading it now: FEDERAL WARRANT. This warrant is issued this eleventh day of December in the year of Our Lord Eighteen Hundred and Seventy-One and duly executed by the hand of United States Army Major General Philip H. Sheridan of Fort Sill, the Indian Territory of these United States of America. The fugitives Mudlark Abercromby MacGyver alias "Muddy Charlie," alias "Mudshoe," alias "Pensicola Thelma," and one Major Richard Carter, alias "Gentleman Rick," alias "Poor Richard," alias "Gumball Ricky," both formerly of the Confederate States Army, having been implicated by observation and circumstance of innumerable delicta, dacoiteries, iniquities, infringements, infractions, and indeed immorality, as well as trangressions, trespassing and trainstopping, are considered deleterious and detrimental to the welfare of the State, and THEREFORE, ordered thereupon that a Mittimus be made out to keep them confined until such time as they be discharged for proper hanging -- It's signed by the General."

"Mittimus?"

"I reckon it's after Thanksgiving, before Easter." 

Muddy gives you that familiar old look that always leads to trouble. "I got me another cunning plan. C'mon, ask your old buddy Muddy..." Muddy leans forward, clearly impatient for you to ask him about his latest stroke of (in his opinion) genius."

>ask muddy about plan
Muddy says excitedly, "Here's my idea: I reckon I could take that warrant and forge a different ending. Maybe trick them into releasing us."

"That's a great idea, Muddy, let me get my pen and some ink. Oh, wait a minute. I don't have either!" You glare at Muddy.

"Oh, yeah. I suppose. I didn't think of that." Muddy considers the matter. "Maybe we could make one. If you can find something that I can use as a pen, I reckon we can squish something or other up to make some kind of ink for it."

>give feather to muddy
"Thanks, partner. That'll make a right proper pen."

He continues, "To finish this business with the warrant, I'll need something to serve as ink."

* * *

>give warrant to muddy
Muddy accepts the document and stares at it for a while, turning it this way and that.

Muddy applies his quill to the paper and with a few flourishes, scrawls an additional sentence on the warrant. He blows gently on it to dry the "ink" and hands the warrant back to you for your inspection.

>read warrant
It says: FEDERAL WARRANT. This warrant is issued this eleventh day of December in the year of Our Lord Eighteen Hundred and Seventy-One and duly executed by the hand of United States Army Major General Philip H. Sheridan of Fort Sill, the Indian Territory of these United States of America. The fugitives Mudlark Abercromby MacGyver alias "Muddy Charlie," alias "Mudshoe," alias "Pensicola Thelma," and one Major Richard Carter, alias "Gentleman Rick," alias "Poor Richard," alias "Gumball Ricky," both formerly of the Confederate States Army, having been implicated by observation and circumstance of innumerable delicta, dacoiteries, iniquities, infringements, infractions, and indeed immorality, as well as trangressions, trespassing and trainstopping, are considered deleterious and detrimental to the welfare of the State, and THEREFORE, ordered thereupon that a Mittimus be made out to keep them confined until such time as they be discharged for proper hanging of the Sheriff's portrait on the office wall.

>x deputy
You are relieved to find that the deputy is unconscious, but breathing. He is wearing only a pair of pants -- no shirt, no gun belt, no boots.

>wake deputy
The deputy groans deeply and curls up into a ball, rolling towards you and blinking quickly. His half-focused eyes drift from you to disheveled man and finally fix on Muddy, who gives him a full-toothed (as many as Muddy still has, at any rate) grin.

The disoriented deputy asks, "What? What in tarnation happened?"

Muddy takes the initiative, "I reckon you must've drunk some potent firewater, deputy. You plumb passed out. Now, why don't you get up and let us out, we got work to do -- just like it says on that federal warrant."

The dull-witted deputy, still stunned by the recent turn of events, stares at the warrant.

Muddy leans forward and points out, "Down there, near the bottom. It says that we should be discharged to hang up the sheriff's portrait, don't it?"

The deputy yawns and rubs his eyes, "I reckon it do. But I thought you was criminals."

"Oh shucks, no, deputy." Muddy puts on his most endearing smile. "Don't you remember the sheriff asking you to take care of his guests? We were just staying here overnight. Now, why don't you let us out? The sheriff's going to be mad at us all if that picture ain't hung by morning."

The deputy reaches down and does something arcane to the lock. You don't quite see what he did, but it clicks open. He slumps wearily against the jail bars, and the gate swings open, permitting passage eastward into the office.

>e
[Your score has just gone up by five]

Office
A one-room jailhouse is fitting for this jerkwater town. There's a big, wooden desk in the middle of the room. Just behind the desk is a fancy cabinet, with real glass in the door. Next to the cabinet, a large, framed picture of the sheriff stands on the floor. To the side of the desk, there is a weird-looking contraption: clearly, some sort of steam boiler which is connected by pipes to a strange-looking machine. On the opposite side of the room, two swinging doors lead back to town; a small bell hangs on a hook attached to the door. Flash's empty dog food bowl is nailed to the floor just in front of your jail cell.

Muddy leans against the wall.

A dented food bowl sits on the office floor, only a few feet from the jail bars.

You can also see the deputy here.

A repaired stool stands upright.

In the corner of the cell, a disheveled man in a black suit is stretched out on a crude wooden bench and is snoring loudly, oblivious to your presence.

In the jail cell you can also see a can of beans (in which is a spoon).

>x desk
A beat-up old wooden desk with time-worn corners, and a pitted, scratched surface. The rear of the desk has a drawer with a small lock.

>open drawer with key
You unlock the drawer.

>open drawer
You open the drawer, revealing a folder.

>open folder
You open the folder, revealing a telegram, a patent, a note, and a receipt.

>read telegram
It says: "AGREE TO YOUR OFFER [STOP] WILL SUPPLY MACHINE PARTS IN EXCHANGE FOR 5000 US DOLLARS IN SILVER COIN [STOP] CONGRATULATIONS ON WINNING LOTTERY [STOP] SIGNED JEFFRIES & BRAND STEAMWORKS CO LTD [STOP][END]".

>x patent
A thick technical document describing the coffee machine invented by the sheriff. Reading through it, you can see his plans to make these machines in factories and to sell them throughout the country. Your mind reels in horror at the prospect of coffee shops on every street corner selling fancy, steamed beverages.

>x note
The note is written in a flowing cursive script. It reads:

"Dear Sam, I can't go on like this. When you were just a plain old sheriff that was one thing, but since you started inventing stuff, I can see what you are made of. A man that kicks my dog isn't cut out for marrying anyone. I thought you were an honest lawman, but I can see what you've become. Don't come around no more or my pa might just take a disliking to you. I was going to send you my ring, but I found out it was glass. Why am I not surprised? You are a scoundrel and not fit to wear that uniform.

Explicitly not yours,

Ella".

>x receipt
A receipt from Jeffries & Brand Steam Works Co Ltd of Witchita Falls. The receipt is for four hundred dollars worth of pipes and fittings purchased by Sheriff Sam Cheney of Crawdad's Gulch. At the bottom of the note, written in red is the following postscriptum: "Your account with us is severely in arrears. No further credit will be extended. Remit all payments immediately or we will take legal or other actions as required.".

>take telegram
Fetched.

>take patent
Fetched.

>take receipt
Fetched.

>x cabinet
(the cabinet)
About three feet tall, and made of oak. The cabinet's top is covered with circular stains from drink bottles, but the rest of the cabinet is in good shape. Its door covers the front of the cabinet and opens on brass hinges. The contents of the cabinet are recognizable through the cabinet's uneven glass. Despite the distortion, you see what looks like a gun belt some kind of shiny yellow object. Maybe gold, you think, hopefully.

>open cabinet
(the cabinet)
The cabinet opens to reveal two gun belts and a banana.

"Come to papa!" beams Muddy, as he reaches for his gun belt and straps it on.

>take gun belt
You strap on your gun belt.

>take gun
It feels good in your hand.

>x gun
You quickly inspect your gun and are alarmed to discover that it's unloaded.

>put gun in holster
You put the gun into the holster.

>l
Office
There's a big, wooden desk in the middle of the room. Just behind the desk is a fancy cabinet, with real glass in the door. Next to the cabinet, a large, framed picture of the sheriff stands on the floor. To the side of the desk, there is a weird-looking contraption: clearly, some sort of steam boiler which is connected by pipes to a strange-looking machine. On the opposite side of the room, two swinging doors lead back to town; a small bell hangs on a hook attached to the door. Flash's empty dog food bowl is nailed to the floor just in front of your jail cell.

Muddy leans against the wall.

A dented food bowl sits on the office floor, only a few feet from the jail bars.

You can also see the deputy here.

A repaired stool stands upright.

In the corner of the cell, a disheveled man in a black suit is stretched out on a crude wooden bench and is snoring loudly, oblivious to your presence.

In the jail cell you can also see a can of beans (in which is a spoon).

>hang portrait on wall
Muddy walks over to the portrait and hangs it on the wall, calling back to you, "Do this look centered?"

You regard the portait critically, "A little more to the left."

"Good?"

"A little more..."

"Now?"

"There. I'd say it's well-hung."

Muddy raises his eyebrows, but doesn't say anything.

>e
Muddy relents and says, "All right, Rick. I reckon we done what we can done. Let's make for the hills."

As you head out of the office, two men appear in the door way: Sheriff Cheney and Federal Marshal McLuhan. They are followed by a small detachment of U.S. Army guards.

Sheriff Cheney surges forward, pointing his finger at you and Muddy, "It were these two what blown up that train tunnel! They's escaping when we walked in! Look, they done killed my deputy! We should drop 'em where they stand."

The marshal looks uncertain and waves the army guards forward. They train their pistols on you. 

The marshal rests his hand on the sheriff's trigger arm and says, "Sheriff, without any evidence to substantiate your accusation regarding the train robbery, I was reluctant to see these men hanged without a trial. Given the corpse of a lawman in front of us, though, even I have to agree that justice should be swift and definitive in this instance."

>wake deputy
Seeing the sheriff, the deputy sobers up immediately and jumps to his feet. "I was just resting my eyes for a moment, sir, and helping these gentlemen hang your portrait up."

The marshal looks confused and asks the deputy, "Hang up his portrait?"

"Well sure, mister marshal, sir. The sheriff done told me they was our welcome guests and that he wanted his picture hung up."

The marshal raises his eyebrows suspiciously, "You had federal suspects tidying up your office? Sheriff Cheney, I have to say that seems quite sloppy, and not in keeping with the public trust inherent in your position."

Muddy whispers, "Rick, we ain't got long. I reckon that marshal is someone what can be reasoned with."

>show patent to marshal
You show the patent to the marshal and intimate that the sheriff had extensive business plans, far beyond his mandate as a public servant. 

The marshal flips through the patent for the sheriff's invention and looks at you questioningly.

"So?" he asks. "It seems like a clever enough invention, and I presume this work was not done on public time, or using town resources. I also would guess that he will need some big-time investors to put a plan like this into action, but I don't see anything wrong with that. The sheriff's a businessman pure and simple. There isn't anything more American than a man willing to make a profit, when the profit is there for the taking."

The marshal advises, "Citizens, I am required by federal law as it applies to the Territory to advise you that CAPITAL CHARGES have been filed against you, and summary execution will take place, unless evidence to the contrary can be brought to light."

The sheriff rolls his eyes, "For the sake of all that's Hog-Tied and Rightful, whyn't we shoot 'em dead right here?"

The marshal looks at Sheriff Cheney and answers, "Because some of us believe in maintaining some semblance of due process."

>show telegram to marshal
You show the telegram to Marshal McLuhan, telling him that he'll find the sheriff's stagecoach full of stolen silver just behind the jail.

Sheriff Cheney wipes his brow nervously, "I forgot that's where we left that coach. I do reckon I'm always forgetting where I park. I was going to mention the silver as evidence any second now."

The marshal strokes his chin. "You're saying that the sheriff intended to abscond with these funds instead of turning them over to state's evidence? Can you show me any additional evidence that would corroborate this grave accusation? I'm not inclined to distrust an officer of the law. It is true that the sheriff had some personal business concerns, but I have seen nothing to make me suspect that he was lacking for funds."

Muddy whispers, "We got to show that marshal something. I reckon maybe we could make up some kind of excuse or shift the blame, maybe."

>show receipt to marshal
You show the marshal the receipt and suggest that the sheriff is quite in debt, and might turn to illegal activities to pay it off. 

The marshal dispatches two guards to search behind the office, and when they return with corroboration about the stolen silver, the marshal instructs his guards to restrain and disarm the sheriff, concluding, "So, now it is clear. The sheriff took advantage of the railway incident to rob the train's silver himself in order to finance the development of his invention into a business. He framed these two itinerant laborers to shift the blame. No wonder he wanted them killed so quickly."

The marshal rips the gold star off Sheriff Cheney's shirt and instructs the guards, "Place Mr. Cheney behind bars."

disheveled man yawns and walks out of the cell as the guards wrestle the sheriff past him. "I do reckon I slept like the dead last night. Thank you for a peaceful night, deputy," and he walks out the front door.

The marshal raises his eyebrows but continues, "Deputy James Smith Bush, by the power invested in me as federal marshal of this district, I hereby promote you to Sheriff of the Town of Crawdad's Gulch. Congratulations." The newly appointed sheriff grins and shakes his hand. The marshal almost pins the star to Jimbo's bare chest, but stops short and just hands it to him. The marshal advises him, "James, you'll probably want to get yourself some deputies -- men you can trust."

Sheriff Jim looks over to you and Muddy. The color drains from Muddy's face.
[Your score has just gone up by five]

*** YOU WIN ***

Would you like to RESTART, RESTORE a saved game, see some suggestions for AMUSING things to do, or QUIT?

>amusing
Congratulations, partner. That sure could have turned a whole mess more ugly, but you same out of it with your neck. Before you ride off into the sunset, why don't you rest your eyeballs on some of the stuff in the game that maybe you ain't run into:

* Did you try chewing the tobacco and spitting at everything in sight? How "bout old Flash?

* There are three ways of driving the deputy out of the jail, how many did you find?

* Did you try reading the initials engraved on the stool?  Repeatedly?

Some other random trivia:

* The game is set in the Indian Territory, which would later become the Oklahoma territory and subsequently the state. How many references can you find to the musical "Oklahoma!"?

* In the real West, it wouldn't have made any sense to put beans in a can. They were a cheap staple, transported dry, likely in sacks.

* Boot spurs were referred to as "can openers" in the Old West. Really.

* The transcontinental railroad was completed in 1869, but it crossed two states above Oklahoma. The first railroads in Oklahoma were built in 1870, and the state wasn't crossed until 1871.

* The espresso machine was invented in 1901 in Italy, but we figured that so many Old West movies came from Italy, that it would look natural enough in our story.

* The slang "hoosegow" comes from the Spanish juzgado, which was a type of judge tribunal.

Finally, if you've read this far down the page, you deserve to know about the "EASTER EGG" command, which will reveal several alternate endings to the story. Explore them at your own risk.

Would you like to RESTART, RESTORE a saved game, see some suggestions for AMUSING things to do, or QUIT?

* * *

>þ
In the twilight, you sight the sheriff's sturdy brick office near the edge of town. "That's mighty fine construction," notes Muddy, sounding less feisty now. "Mighty fine indeed." The coach rolls to a halt and a thick arm yanks you roughly from your seat. You land awkwardly in the rutted street, where the sheriff holds you in place with the heel of one boot. He yells to his men, "Bring the coach around back, we got to impound that evidence." You are shoved into the sheriff's office and then into a small holding cell.

The deputy wakes with a start, whips his dusty boots off the desk and stands, tucking his shirt back into his pants. The sheriff gives him a brief, judgmental glance and offhandedly tosses an arrest warrant on the desk. He barks, "Jimbo, listen up. Picked up these two down near the train. A federal marshal will be coming for them at eight o'clock tomorrow morning. There's going to be a hanging!" The deputy nods slowly. The sheriff continues, "Please take care of our 'guests'. I got to head down to Wichita Falls to discuss my invention with some investors, so you is in charge." The deputy smiles until the sheriff adds, "Jimbo, don't screw up," as he heads out the door.

Jail Cell
Why are you not surprised to have landed right back in the hoosegow after another one of Muddy's dubious plans? Will you ever learn? How did it come to this? 

The small jail cell is brick on three sides, metal bars on the other, with a tightly locked gate. A small window is set into the brickwork above your head. Through the jail bars you can see the sheriff's office.

A broken stool lies on the floor.

Muddy leans against the wall tapping a harmonica on his arm.

In the corner of the cell, a disheveled man in a black suit is stretched out on a crude wooden bench and is snoring loudly, oblivious to your presence.

>x bench
A long wooden bench made of rough, splintery planks. Under the bench, you notice a piece of questionable meat, a spoon and a metallic can.

On the other side of the jail bars in the office, the deputy makes you nervous as he waves his gun back and forth, jerking the barrel up and shaping the words "Pow! Pow!" with his lips.

>x meat
The deputy has been watching you and he smiles sardonically. "I see you found your dinner. Or was that last week's dinner? Har, har!"

You are distracted by his comment and forget what you were doing.

>take can
Fetched.

Muddy seems lost in thought.

>take spoon
Fetched.

>x can
A closed metal can labeled "BEANS". On the back, some fine print says, "Precooked beans. No claim is made regarding the cardioprotective nature of this product. May cause abdominal distension if ingested. No fitness of purpose is implied. No warranty is provided for personal or other injury, or injury or loss related directly or indirectly to the use of this product. By opening this can, you agree to the terms of service posted in town."

Over in the office, the deputy sniffles loudly and wipes his nose on his sleeve.

>x boots
Black boots that have seen better days. The left boot is missing its heel spur.

>x right boot
A cowhide boot that has been rubbed smooth. A metal riding spur is about ready to fall off the worn-down heel.

On the other side of the jail bars in the office, the deputy pokes his head out of the office and yells at some passersby.

>take sopur
You ain't able to see no such thing.

>take spur
You yank the spurs off your right boot, careful not to cut yourself in the process.

>open can with spur
Muddy cranes his neck to see what you're doing. He's never seen someone open a can with heel spurs. You slide the spur into the groove along the top of the can, and wiggle it back and forth. The can revolves, and the lid is nearly sawn off. It is hard to tell which of you is more surprised that this worked. 

[Your score has just gone up by five]

Back in the office, the deputy reaches into his pocket, produces a strip of beef jerky, and chews on it for a while.

>eat beans
When you were a child, you remember visiting your cousins, who all liked beans. Your aunt insisted that if they could eat beans, so could you. You choked on them, and coughed them up, and they made fun of you. Since then, you don't even like the way they smell. The beans, that is. Actually, your cousins are kind of rank too.

Nonetheless, your stomach is growling and you could do with a meal.

[You have dealt with a repressed childhood memory in a constructive manner, your score just went up by two points]

>g
The beans disgust you even more than the rancid meat.

[The thought is enough to make you lose a point.]

Not far from your jail cell, the boiler gurgles and bubbles quietly.

>g
No. It's a matter of principle now.

[Your score just went back up by a point for being so principled.]

>g
Give Muddy the damn beans. He likes them, but you can't stand to even look at them.

Over in the office, the deputy stares at Muddy.

>give beans to muddy
Muddy takes the can and stares hungrily at the beans.

Even in the most dire situation, Muddy's appetite remains intact. He looks expectantly at you and says, "Rick, got a spoon?"

Muddy murmurs to himself about not being able to recall a limerick he once heard that had something to do with cowboys and farmers.

>give spoon to muddy
Muddy cracks a gap-toothed smile and says, "Much obliged," before digging into the can of beans like a miner hot on a fresh gold vein. A couple moments later, he finishes circling the inside of the can with the spoon, trying to get every last drop of bean juice into his mouth. Afterwards, he places the can and spoon on the floor and rubs his stomach with satisfaction.

Muddy has an aura of well-fed contentment.

* * *

>z
Time passes.

You hear nothing. The smell nearly knocks you out. Vision fades, the room spins.

Muddy whispers in that understated manner of his, "That were a silent but deadly."

"Ain't you even a speck curious to ask me about my plan?" taunts Muddy.

>z
Time passes.

Suppressing the urge to throw up from the smell, the deputy reaches over to the whiskey bottle and half drains it on his way out the door.

The fragrance gradually improves as the universe cools.
[Your score has just gone up by one]

"Truthful, Rick," whispers Muddy solemnly, "this ain't like all my other plans, this one is iron-clad. Ask me about it. Go ahead." 

Muddy strokes his whiskers.

>z
Time passes.

Muddy vibrates with excitement and gushes, "I got to tell you, Rick, or this new plan of mine is going to drive me plumb crazy!" 

"Let's keep this between us, though", he whispers.

He notices the sleeping man in your cell for the first time. "Don't know about him." Muddy jerks his thumb towards the sleeping figure. "Might be a spy."

Muddy leans towards you, his face barely an inch from your ear and his buzzard-worthy breath even less so from your nose. "Okay, Rick, I'm a-going to tell you my plan." Muddy pauses dramatically. "Here it is: we got to break out of this jail before we get strunged up."

"That's it? That's your whole damn plan? That don't count as no plan!" you fume.

"Keep it down, Rick!" Muddy's gaze darts over to your third cellmate. "Yeah, that's it for now. It takes time to cook up a good plan. You need lots of ingredients."

"Muddy Charlie," you retort, "I heared you was the worst cook in the Confederate Army. Your cooking like as did more damage than Sherman's March."

Muddy gives you a hurt look and sulks in the corner. After a while, you regret being so quick-tempered with your old buddy.

* * *

>take harmonica
"I ain't never seen you play the mouth organ, Muddy."

Your partner turns the harmonica back and forth. "That's 'cuz I ain't never learned how," he replies.

Muddy hands the harmonica to you.

>play harmonica
Tentatively, you blow a few notes. The bars in the jail cell rattle sympathetically.

"Look at that, boy", Muddy laughs, "I swear that screw up there holding that bar is wiggling loose!"

Muddy rubs his belly and says, "I reckon I could do with a snack right about now."

>g
Again, the room resonates with the rich and vibrant tones of a bagpipe connected to the blowhole of a beluga whale.

Muddy points excitedly towards the top of the gray bar, "When you played, that screw worked its way out more. It's like you got some kind of sonic screwdriver or something! I think one more time will do it."

Flash nuzzles up to the boiler.

>g
The screw vibrates out of the ceiling, rebounds off the concrete floor in a shower of sparks, and rolls under the deputy's desk. A hollow gray tube falls loose from the upper reaches of the jailbars and lands at your feet.

"You done it!" shouts Muddy.

Flash swallows loudly.

>g
You blow a few more notes, but you're not getting any better.

Muddy picks some food from between his teeth.

>g
You blow a few more notes, but you're not getting any better.

A yellow-fringed surrey trots past the sheriff's office.

>take bar
(the gray tube)
You grab the bar.

You hold it lengthwise and stare down its hollow shaft at Muddy. He looks back at you. 

"Don't that just beat all," ponders Muddy.
[Your score has just gone up by one]

* * *

>put berry in bar
(the gray tube)
You drop the berry into the gray tube.

>take off left boot
There are people within a thousand yards. Are you sure?

(yes or no) >

>y
You rock back and forth on the floor, locked in a death struggle with your foot. Beads of sweat form on your head, as you struggle to twist and pull the boot off. With a sudden sucking pop, the boot relents and you tumble backwards.

Muddy's eyes water as he complains, "Ain't you got no sense of smell in that head of yours?"

To which you reply, "Not after I been downwind of you around feeding time, nope. This ain't nothing next to what you can do with a can of beans!"

Flash wakes with a start and sneezes loudly. The fur on his back bristles, and he opens his eyes to stare in horror at your feet. He backs away, towards the front door. The leash pulls taut. He seems caught in the balance between an urge to run away from your stinky foot and his own laziness, which holds him to the spot.

>take off right boot
Oh, you really don't want to do that. Not indoors at least. Are you sure?

(yes or no) >

>z
Ain't you got no manners? Answer yes or no.

>take off right boot
Ain't you got no manners? Answer yes or no.

>y
You rock back and forth on the floor, locked in a death struggle with your foot. Beads of sweat form on your head, as you struggle to twist and pull the boot off. With a sudden sucking pop, the boot relents and you tumble backwards.

Muddy's eyes water as he complains, "Not again! My poor nose!"

One foot was bad enough, but two is more than the old dog can handle. Trying not to sniff the air, Flash turns tail and breaks for the door, straining against his leash, which is tied to the steam pipe lever. The lever swings towards the door, and from the roof you hear the ear-splitting drone of a railway steam whistle.

You agree with with Muddy that the deputy is not likely to be in a good mood when he arrives, so you put your boots back on.

>blow berry at bell
Your projectile ricochets off the bell with a metallic "ding!"

Flash reflexively jumps towards his feeding bowl, pulling the lever and somehow causing the machine to rattle and buzz. Finding no food, the despondent dog returns to his favorite place in front of the boiler, shutting off the coffee machine.

The Deputy slams through the swinging doors to the office, lurching to the side as he struggles to put his other leg into his pants. He is bare-chested and empty-handed, aside from a nearly empty bottle of whiskey.

The deputy thunders, "What the cluster-chucking blazes is the matter here?" The deputy surveys the office quickly and then rattles the gate to make sure it is still locked. In his drunken rage, he doesn't notice the missing metal bar. 

Satisfied that you haven't escaped, he pushes the lever back to the middle position and warns, "I don't know what you were up to what made old Flash trigger-happy, but don't let it happen again."

"Dumb dog," he mumbles, "I was doing important business." The deputy checks the gate again and sets off again towards the door.

The deputy brightens. "Ummm. I do smell me some coffee." The deputy drains the mug with a single gulp. "That's good. I got to wake me up some."

The deputy looks at the two of you.  "Enough is enough.  You jokers stay put, I'll be back again in a bit."

Flash slinks back to his spot near the boiler and lays down again.

>x cup
A white porcelain mug.

>put gray bar in socket
You flip the stool over and wiggle the hollow gray tube into the empty socket. It fits perfectly and remains in place when you let go of the bar, but you think you could yank the gray bar out again if you needed it. You now have a stool with three even legs: two wood, one metal.

* * *

>take berry
You pluck a plump juicy red berry from the part of the vine growing outside the window.

>get down
You jump down to the ground again.

Jail Cell
The small jail cell is brick on three sides, metal bars on the other, with a tightly locked gate. A small window is set into the brickwork above your head. Through the jail bars you can see the sheriff's office.

A repaired stool stands upright.

Muddy leans against the wall.

In the corner of the cell, a disheveled man in a black suit is stretched out on a crude wooden bench and is snoring loudly, oblivious to your presence.

You can also see a can of beans (in which is a spoon) and a hunk of meat here.

A dented food bowl sits on the office floor, only a few feet from the jail bars.

On the machine is a cup.

In the office you can also see Flash.

>take metal bar
I only twigged your meaning as far as hankering to take the can of beans.

>take gray bar
You yank the bar out of the stool's socket.

>put berry in gray bar
You drop the berry into the gray tube.

>blow berry at coffee
You ain't able to see no such thing.